あい	会い 合い 明い 空い 逢い 遇い 遭い 開い
あいしあい	愛しあい 愛し合い
あいしあう	愛しあう 愛し合う
あいしあえる	愛しあえる 愛し合える
あいしあっ	愛しあっ 愛し合っ
あいしあわ	愛しあわ 愛し合わ
あう	会う 合う 逢う 遇う 遭う
あえ	会え 合え 和え 逢え 遇え 遭え
あえる	会える 合える 和える 逢える 遇える
あえれ	会えれ 和えれ
あおい	仰い 扇い 煽い
あおう	会おう 合おう 逢おう 遇おう 遭おう
あおが	仰が 扇が 煽が
あおぎ	仰ぎ 扇ぎ 煽ぎ
あおぐ	仰ぐ 扇ぐ 煽ぐ
あおざめ	蒼ざめ 蒼褪め 青ざめ 青褪め
あおざめる	蒼ざめる 青ざめる 青褪める
あおっ	会おっ 呷っ 煽っ
あおみ	蒼み 青み
あおら	呷ら 煽ら
あおり	呷り 煽り
あおりたて	あおり立て 煽りたて 煽り立て
あおりたてよう	煽りたてよう 煽り立てよう
あおりたてる	あおり立てる 煽りたてる 煽り立てる
あおる	アオる 呷る 煽る
あか	明か 空か 開か
あかさ	明かさ 明さ 証さ
あかさび	赤さび 赤錆び
あかし	明かし 明し 証し 飽かし
あかす	明かす 明す 空かす 証す 飽かす
あかせ	明かせ 飽かせ
あかちゃけ	赤ちゃけ 赤茶け
あかぬけ	あか抜け アカ抜け 垢抜け
あからむ	明らむ 赤らむ
あがっ	アガっ 上がっ 和了っ 挙がっ 挙っ 揚がっ 揚っ 騰がっ
あがない	購い 贖い
あがなう	購う 贖う
あがなえ	購え 贖え
あがなえる	購える 贖える
あがなおう	購おう 贖おう
あがなっ	購っ 贖っ
あがなわ	購わ 贖わ
あがら	アガら 上がら 和了ら 挙がら 挙ら 揚がら 揚ら 食ら 騰ら
あがり	アガり 上がり 和了り 挙がり 挙り 揚がり 揚り 騰がり
あがりこま	上がりこま 上がり込ま
あがりこみ	上がりこみ 上がり込み
あがりこむ	上がりこむ 上がり込む 上り込む
あがりこん	上がりこん 上がり込ん 上り込ん
あがる	アガる 上がる 和了る 挙がる 挙る 揚がる 揚る 食る 騰がる
あがれ	アガれ 上がれ 和了れ 揚がれ
あがれる	上がれる 和了れる
あき	倦 倦き 厭き 明き 空き 開き 飽き
あきたら	飽きたら 飽き足ら
あきたり	飽きたり 飽き足り
あきらめ	断め 明め 明らめ 諦め
あきらめる	明らめる 諦める
あきる	厭きる 飽きる
あきれ	呆れ 飽きれ
あきれかえっ	あきれ返っ 呆れかえっ 呆れ返っ
あきれかえら	呆れかえら 呆れ返ら
あきれかえり	あきれ返り 呆れかえり 呆れ返り
あきれかえる	あきれ返る 呆れかえる 呆れ返る
あきれる	呆れる 飽きれる
あく	明 明く 空く
あくる	明くる 明る
あけ	明 明け 暁け 空け 開け
あけくれ	明けくれ 明け暮れ
あけくれる	明けくれる 明け暮れる
あけはなし	明け放し 開け放し
あけはなた	明け放た 開け放た
あけよう	明けよう 空けよう 開けよう
あける	明ける 空ける 開ける
あけれ	明けれ 空けれ 開けれ
あけわたさ	明け渡さ 明渡さ 開け渡さ
あけわたし	あけ渡し 明け渡し 明渡し 空け渡し 開け渡し
あけわたす	あけ渡す 明け渡す 明渡す 空け渡す 開け渡す
あけわたせ	明け渡せ 明渡せ
あげ	上げ 呈げ 挙げ 揚げ 擧げ 舉げ
あげよ	上げよ 挙げよ 揚げよ
あげよう	上げよう 挙げよう 揚げよう
あげる	上げる 挙げる 揚げる 擧げる
あげれ	上げれ 挙げれ
あげれる	上げれる 挙げれる
あげろ	上げろ 挙げろ 揚げろ
あげん	上げん 挙げん 揚げん
あこがれ	憧れ 憧憬れ 憬れ
あこがれる	憧れる 憧憬れる 憬れる
あざけっ	嘲けっ 嘲っ
あざけら	嘲けら 嘲ら
あざけり	嘲けり 嘲り
あざけりわらっ	あざけり笑っ 嘲り笑っ
あじわい	味い 味わい
あじわう	味う 味わう
あじわっ	味っ 味わっ
あじわわ	味わ 味わわ
あずかっ	与かっ 与っ 預かっ 預っ
あずから	与から 与ら 預から 預ら
あずかり	与かり 与り 預かり 預り
あずかりしっ	あずかり知っ 与り知っ
あずかりしら	あずかり知ら 与り知ら 預かり知ら
あずかりしる	あずかり知る 与り知る 預かり知る
あずかる	与かる 与る 預かる 預る
あずかれ	与かれ 与れ 預かれ 預れ
あずかれる	与れる 預かれる
あずかろう	与かろう 与ろう 預かろう
あずけいれ	預け入れ 預入れ
あずけいれる	預け入れる 預入れる
あずけかえ	預けかえ 預け替え
あせる	アセる 焦る 褪せる
あそびくらし	遊び暮し 遊び暮らし
あそびたおす	遊びたおす 遊び倒す
あそびたわむれる	遊びたわむれる 遊び戯れる
あそびほうけ	遊びほうけ 遊び呆け 遊び惚け
あそびほうける	遊びほうける 遊び呆ける 遊び惚ける
あそびまわっ	遊びまわっ 遊び回っ 遊び廻っ
あそびまわり	遊びまわり 遊び回り
あそびまわる	遊びまわる 遊び回る 遊び廻る
あたえ	与え 給え 與え
あたえあい	与えあい 与え合い
あたえあう	与えあう 与え合う
あたえあっ	与えあっ 与え合っ
あたえよ	与えよ 給えよ
あたえる	与える 給える 與える
あたえん	与えん 給えん
あたたまっ	暖っ 暖まっ 温っ 温まっ
あたたまら	暖まら 暖ら 温まら 温ら
あたたまり	暖まり 温まり 温り
あたたまる	暖まる 温まる
あたたまれ	暖まれ 温れ
あたたまろう	暖まろう 温まろう
あたため	暖め 温め
あたためよう	暖めよう 温めよう
あたためる	暖める 温める
あたっ	中っ 当たっ 当っ 能っ
あたら	アタら 中ら 当たら 当ら
あたり	中り 当たり 当り 當り
あたりちらさ	当たり散らさ 当り散らさ
あたりちらし	あたり散らし 当たりちらし 当たり散らし 当り散らし
あたりちらす	当たり散らす 当り散らす
あたる	アタる 中る 当たる 当る 當る
あたれ	当たれ 当れ 當れ
あたれる	当たれる 当れる
あっ	あ あッ 会っ 合っ 在っ 有っ 逢っ 遇っ 遭っ 非ッ
あつかい	扱い 扱かい
あつかっ	扱かっ 扱っ
あつかわ	扱かわ 扱わ
あつまら	聚ら 集まら
あつまり	集まり 集り
あつまる	集まる 集る
あつまれ	集まれ 集れ
あつめ	聚め 蒐め 輯め 集め
あつめる	蒐める 集める
あて	中て 充 充て 宛て 当て 當て
あてがい	充てがい 宛がい 宛てがい 宛行い 当てがい
あてがう	充てがう 宛がう 宛てがう 宛行う 当てがう
あてがっ	充てがっ 宛がっ 宛てがっ 宛行っ 当てがっ
あてがわ	充てがわ 宛がわ 宛てがわ 宛行わ 当てがわ
あてこすり	当てこすり 当て擦り
あてこむ	アテコむ 当て込む
あてこん	当てこん 当て込ん
あてつける	当てつける 当て付ける
あてはまっ	当てはまっ 当て嵌まっ
あてはまら	当てはまら 当て嵌まら 当て嵌ら
あてはまり	当てはまり 当て嵌まり 当て嵌り
あてはまる	当てはまる 当て嵌まる 当て嵌る
あてはまれ	当てはまれ 当て嵌まれ
あてはめ	当てはめ 当て嵌め
あてはめよう	当てはめよう 当て嵌めよう
あてはめる	当てはめる 当て嵌める
あてはめれ	当てはめれ 当て嵌めれ
あてよ	充てよ 当てよ
あてよう	アテよう 充てよう 当てよう
あてる	アテる 中てる 充てる 宛てる 当てる 當てる
あてれ	アテれ 充てれ 当てれ
あてろ	宛てろ 当てろ
あとじさっ	後じさっ 後退っ
あとじさり	後じさり 後退り
あとづけ	跡づけ 跡付け
あとづける	跡づける 跡付ける
あは	会は 合は 逢は 遇は
あばい	暴い 発い
あばか	暴か 曝か 発か
あばき	暴き 発き
あばきたて	暴きたて 暴き立て
あばきださ	暴きださ 暴き出さ
あばきだし	あばき出し 暴きだし 暴き出し
あばきだす	あばき出す 暴きだす 暴き出す
あばきだそう	暴きだそう 暴き出そう
あばく	暴く 曝く 発く
あばれまわっ	暴れまわっ 暴れ回っ
あばれまわり	暴れまわり 暴れ回り
あばれまわる	暴れまわる 暴れ回る
あばれまわれ	暴れまわれ 暴れ回れ
あひ	会ひ 合ひ 會ひ 逢ひ 遇ひ
あびせ	浴せ 浴びせ
あびせかけ	浴びせかけ 浴びせ掛け
あびせかける	浴びせかける 浴びせ掛ける
あびせたおし	あびせ倒し 浴びせ倒し
あふ	会ふ 合ふ 逢ふ 遇ふ
あふれかえっ	あふれ返っ 溢れかえっ 溢れ返っ
あふれかえら	あふれ返ら 溢れかえら 溢れ返ら
あふれかえり	あふれ返り 溢れかえり 溢れ返り
あふれかえる	あふれ返る 溢れかえる 溢れ返る
あふれださ	あふれ出さ 溢れ出さ
あふれだし	あふれ出し 溢れだし 溢れ出し
あふれだす	あふれ出す 溢れだす 溢れ出す
あふれで	あふれ出 溢れ出
あふれでる	あふれ出る 溢れ出る
あぶらぎっ	油ぎっ 脂ぎっ
あぶりださ	あぶり出さ 炙り出さ
あぶりだし	あぶり出し 炙り出し 焙り出し
あぶりだす	あぶり出す 炙り出す 焙り出す
あぶりだそう	あぶり出そう 炙り出そう
あへ	会へ 合へ 逢へ
あまかける	天かける 天翔ける 天翔る
あまくだっ	天下っ 天降っ
あまくだり	天下り 天降り
あまくだる	天下る 天降る
あます	余す 餘す
あまてらす	天てらす 天照らす
あまら	余ら 剰ら
あまり	余り 剰り
あまれ	余れ 餘れ
あみあげ	編みあげ 編み上げ 編上げ
あみあげる	編みあげる 編み上げる
あみこま	編みこま 編み込ま
あみこみ	編みこみ 編み込み
あみこむ	編みこむ 編み込む
あみこん	編みこん 編み込ん
あみださ	あみ出さ 編みださ 編み出さ
あみだし	あみ出し 編みだし 編み出し 編出し
あみだす	編みだす 編み出す
あやしみ	怪しみ 怪み
あやしむ	怪しむ 怪む
あやしん	怪しん 怪ん
あやぶま	危ぶま 危ま
あやぶみ	危ぶみ 危み
あやぶむ	危ぶむ 危む
あやぶめ	危ぶめ 危め
あやぶん	危ぶん 危ん
あやまっ	誤っ 誤まっ 誤ッ 謝っ 謝まっ
あやまら	誤まら 誤ら 謝ら
あやまらさ	誤らさ 謝らさ
あやまり	誤まり 誤り 謝まり 謝り 謬り
あやまる	誤まる 誤る 謝まる 謝る 謬る
あやまれ	誤れ 謝れ 謬れ
あやまろう	誤ろう 謝ろう
あゆみだす	あゆみ出す 歩み出す
あゆみより	歩みより 歩み寄り
あゆみよる	歩みよる 歩み寄る
あら	在ら 有ら 莫ら
あらいあげ	洗いあげ 洗い上げ
あらいおとし	洗い落し 洗い落とし
あらいおとそう	洗い落そう 洗い落とそう
あらいきよめ	洗い浄め 洗い清め
あらいきよめる	洗い浄める 洗い清める
あらいなおさ	洗いなおさ 洗い直さ
あらいなおし	洗いなおし 洗い直し
あらいなおす	洗いなおす 洗い直す
あらくれ	荒くれ 荒らくれ
あらさ	荒さ 荒らさ
あらし	荒し 荒らし
あらしまわっ	荒しまわっ 荒し回っ 荒らし回っ
あらしまわり	荒し回り 荒らし回り
あらしまわる	荒しまわる 荒し回る 荒らし回る
あらす	荒す 荒らす
あらそう	争う 荒そう 荒らそう
あらたまっ	改まっ 革まっ
あらたまら	改まら 改ら 革ら
あらたまり	改まり 革まり
あらたまる	改まる 革まる
あらたまれ	改まれ 改れ
あらため	改ため 改め 検め 革め
あらためる	改める 検める 革める
あらだて	荒だて 荒立て
あらわさ	洗わさ 現さ 現はさ 現わさ 著さ 著わさ 表さ 表わさ 顕さ
あらわし	現し 現はし 現わし 著し 著わし 表し 表わし 顕し
あらわす	現す 現はす 現わす 著す 著わす 表す 表わす 顕す
あらわせ	洗わせ 現せ 現はせ 現わせ 著せ 表せ 表わせ
あらわせる	現せる 著せる 表せる 表わせる
あらわそう	現そう 現わそう 著そう 著わそう 表そう 表わそう
あらわれ	現れ 現われ 表はれ 表れ 表われ 顕れ 顕われ
あらわれで	現れ出 現われ出 表れ出
あらわれでる	あらわれ出る 現れ出る
あらわれよう	現れよう 現われよう
あらわれる	現れる 現われる 著れる 表れる 表われる 顕れる 顕われる
あらわれれ	現れれ 現われれ 表れれ 顕れれ
あり	在り 富裕 有り 莫
ありあまっ	あり余っ 有りあまっ 有り余っ 有余っ
ありあまり	あり余り 有り余り
ありあまる	あり余る 有り余る
ありあわせ	あり合わせ 在り合わせ 有りあわせ
ありつけ	あり付け 有り付け
ありふれ	有りふれ 有り触れ
ある	在る 富裕 有る 莫
あるきまわっ	歩きまわっ 歩き回っ 歩き廻っ
あるきまわり	歩きまわり 歩き回り 歩き廻り
あるきまわる	歩きまわる 歩き回る 歩き廻る
あれ	在れ 有れ 荒 荒れ 莫れ
あれる	荒る 荒れる
あろう	在ろう 有ろう
あわ	会わ 合わ 逢わ 遇わ 遭わ
あわさ	会わさ 併さ 合さ 合わさ 逢わさ 遭わさ
あわさっ	合さっ 合わさっ
あわし	会わし 併し 合し 合わし 遭わし
あわす	会わす 併す 合す 合わす
あわせ	会わせ 併せ 併わせ 協せ 合せ 合わせ 遭わせ
あわせおこなう	あわせ行う 併せ行う
あわせかんがえ	併せ考え 合わせ考え
あわせかんがえる	併せ考える 合わせ考える
あわせかんがえれ	併せ考えれ 合わせ考えれ
あわせのむ	併せ呑む 併せ飲む
あわせもた	併せ持た 合わせ持た
あわせもち	あわせ持ち 併せもち 併せ持ち 合わせもち 合わせ持ち
あわせもちい	あわせ用い 併せ用い
あわせもちいる	あわせ用いる 併せ用いる
あわせもっ	あわせ持っ 併せもっ 併せ持っ 合わせもっ 合わせ持っ
あわせもつ	あわせ持つ 併せもつ 併せ持つ 合せ持つ 合わせもつ 合わせ持つ
あわせよう	併せよう 合せよう 合わせよう
あわせる	併せる 合せる 合わせる
あわせれ	併せれ 合せれ 合わせれ
あわそう	会わそう 合わそう
あわだち	あわ立ち 泡だち 泡立ち
あわだっ	泡だっ 泡立っ
あわだつ	あわ立つ 泡立つ 粟立つ
あわだて	あわ立て 泡だて 泡立て
あわだてる	あわ立てる 泡立てる
あわて	周章て 慌て
あわれま	哀れま 憐れま
あわれみ	哀れみ 愍み 愍れみ 憐み 憐れみ
あわれむ	哀れむ 愍れむ 憐む 憐れむ 憫む
あわれめ	憐め 憐れめ
あわれん	哀れん 憐れん 憐ん 憫ん
あん	有ん 編ん
あんじ	按じ 案じ
あんずる	按ずる 案ずる
い	射 居 言 鋳
いあわせ	居あわせ 居合せ 居合わせ
いあわせる	居あわせる 居合わせる
いい	云い 言い 謂い 逝い
いいあい	言いあい 言い合い
いいあう	言いあう 言い合う
いいあえる	言いあえる 言い合える
いいあっ	言いあっ 言い合っ
いいあて	いい当て 言いあて 言い当て
いいあらそっ	いい争っ 言い争っ
いいあらわさ	言いあらわさ 言い表さ 言い表わさ 言表さ
いいあらわし	いい表し 言いあらわし 言い表し 言い表わし 言表し
いいあらわす	いい表す 言いあらわす 言い表す 言い表わす
いいおい	言いおい 言い置い
いいかえ	いい換え 言いかえ 言い変え 言い換え 言い替え 言換 言換え
いいかえし	いい返し 言い返し
いいかえす	言いかえす 言い返す
いいかえよう	言いかえよう 言い換えよう
いいかえる	言いかえる 言い変える 言い換える 言い替える 言換える
いいかえれ	いい換えれ 云いかえれ 言いかえれ 言い変えれ 言い換えれ 言い替えれ
いいかけ	云いかけ 言いかけ 言い掛け
いいきかせ	いい聞かせ 言いきかせ 言い聞かせ 言聞かせ
いいきかせる	言いきかせる 言い聞かせる
いいきっ	いい切っ 言いきっ 言い切っ
いいきり	言いきり 言い切り
いいきる	いい切る 云い切る 言いきる 言い切る
いいきれ	いい切れ 云い切れ 言いきれ 言い切れ
いいきれる	言いきれる 言い切れる
いいくるめ	言いくるめ 言い包め
いいこめる	言いこめる 言い込める
いいしれ	いい知れ 言い知れ
いいすて	言いすて 言い捨て 言い棄て 言捨て
いいすてる	いい捨てる 言い捨てる
いいたて	言いたて 言い立て 言立 言立て
いいたてる	言いたてる 言い立てる
いいつかっ	言いつかっ 言い付かっ
いいつくろい	言いつくろい 言い繕い
いいつくろっ	言いつくろっ 言い繕っ
いいつくろわ	言いつくろわ 言い繕わ
いいつけ	言いつけ 言い付け 言付け
いいつける	言いつける 言い付ける 言付ける
いいつたえ	いい伝え 云い伝え 言い伝え
いいつのっ	言いつのっ 言い募っ
いいつのり	言いつのり 言い募り
いいつのる	言いつのる 言い募る
いいならわさ	言いならわさ 言い習わさ
いいならわし	言いならわし 言い習わし 言習わし
いいのこさ	いい残さ 言い残さ 言い遺さ
いいのこし	いい残し 言いのこし 言い残し 言い遺し 言ひ残し
いいのこす	いい残す 言い残す 言い遺す
いいはっ	言いはっ 言い張っ
いいはなち	いい放ち 言い放ち 言放ち
いいはなっ	いい放っ 云い放っ 言い放っ 言放っ
いいはなつ	言いはなつ 言い放つ
いいはり	言いはり 言い張り
いいはる	言いはる 言い張る
いいふくめ	いい含め 言いふくめ 言い含め
いいふくめる	いい含める 言い含める
いいふらし	言いふらし 言い触らし
いいふらす	言いふらす 言い触らす
いいふらせ	言いふらせ 言い触らせ
いいよっ	言いよっ 言い寄っ 言寄っ
いいよら	言いよら 言い寄ら
いいより	言いより 言い寄り 言寄り
いいよる	いい寄る 言いよる 言い寄る
いいわける	いい分ける 言い分ける
いいわたさ	言いわたさ 言い渡さ 言渡さ
いいわたし	いい渡し 云い渡し 言いわたし 言い渡し 言渡し
いいわたす	言い渡す 言渡す
いう	云う 言う 謂う
いえ	云え 癒 癒え 言え 謂え 謂へ
いえよう	云えよう 癒えよう 言えよう
いえる	云える 癒える 言える
いえれ	癒えれ 言えれ
いおう	云おう 祝う 言おう
いおとさ	射落さ 射落とさ
いおとし	射落し 射落とし
いおとす	射落す 射落とす
いか	イか 去か 往か 行か 逝か
いかえし	射かえし 射返し
いかけ	射かけ 射掛け
いかける	射かける 射掛ける
いかさ	イカさ 活かさ 生かさ 行かさ 逝かさ
いかし	イカし 活かし 生かし 行かし
いかす	イカす 活かす 生かす 行かす
いかせ	活かせ 生かせ
いかせる	活かせる 生かせる
いかそう	イカそう 活かそう 生かそう
いから	活から 生から 瞋ら
いがみあう	いがみ合う 啀み合う
いがみあっ	いがみ合っ 啀み合っ
いき	イき 往き 活き 生 生き 行き 逝き
いきあい	行きあい 行き合い
いきあう	行きあう 行き合う 行き遭う
いきあたっ	行きあたっ 行き当たっ
いきあたり	行きあたり 行き当たり
いきあっ	行きあっ 行き合っ 行き遭っ
いきおいづい	勢いづい 勢い付い
いきおいづか	勢いづか 勢い付か
いきおいづき	勢いづき 勢い付き
いきおいづく	勢いづく 勢い付く
いきおいづけ	勢いづけ 勢い付け
いきおいづける	勢いづける 勢い付ける
いきかえっ	生きかえっ 生き返っ
いきかえら	生きかえら 生き返ら 生き還ら
いきかえる	生きかえる 生き返る 生返る
いきかけ	行きかけ 行き掛け
いきかわり	生き変り 生き変わり
いきすぎ	生き過ぎ 行き過ぎ
いきっ	イキっ 射切っ
いきつい	行きつい 行き着い
いきつか	行きつか 行き着か
いきつき	行きつき 行き着き
いきつく	行きつく 行き着く 行着く
いきつけ	行きつけ 行き着け
いきつこう	行きつこう 行き着こう
いきづい	息づい 息衝い
いきづき	息づき 息衝き
いきづく	息づく 息衝く
いきづまっ	生き詰まっ 行きづまっ 行き詰っ 行き詰まっ
いきづまら	行き詰まら 行き詰ら
いきづまり	息詰まり 行きづまり 行き詰まり 行き詰り
いきづまる	息づまる 息詰まる 行きづまる 行き詰まる 行き詰る
いきとどい	行きとどい 行き届い 行届い
いきとどか	いき届か 行きとどか 行き届か 行届か
いきとどき	いき届き 行き届き 行届き
いきながらえ	生きながらえ 生き存え 生き永らえ 生き長らえ
いきながらえる	生きながらえる 生き存える 生き永らえる 生き長らえる
いきのこっ	生きのこっ 生き残っ 生残っ
いきのこら	生き残ら 生残ら
いきのこり	生きのこり 生き残り 生残り
いきのこる	生きのこる 生き残る 生残る
いきのこれ	生き残れ 生残れ
いきのび	生きのび 生き伸び 生き延び
いきのびよう	生きのびよう 生き延びよう
いきのびる	生きのびる 生き伸びる 生き延びる
いきのびろ	生き伸びろ 生き延びろ
いきまい	息まい 息巻い
いきまき	息まき 息巻き
いきまく	息まく 息巻く
いきゃ	イきゃ 行きゃ
いきる	イキる 射切る 活きる 生きる 生る
いきわかれ	生き別れ 行き別れ
いく	イく 去く 往く 生く 行 行く 行ク 逝く
いけ	イけ 往け 活け 生け 行け 逝け
いけどっ	生け取っ 生け捕っ
いけよう	生けよう 行けよう
いける	イケる 活ける 生ける 行ける 逝ける
いけれ	埋けれ 活けれ 行けれ 逝けれ
いこ	イこ 生こ 行こ
いこう	イこう 憩う 行こう 逝こう
いこっ	憩っ 行こっ
いこふ	イこふ 憩ふ
いこま	射込ま 鋳込ま
いこみ	射込み 鋳込み
いこん	射込ん 鋳込ん
いさぶ	叱 嘖
いさみたた	勇みたた 勇み立た
いさみたっ	勇みたっ 勇み立っ
いさめ	勇め 諌め 諫め
いさめよう	諌めよう 諫めよう
いさめる	諌める 諫める
いざり	膝行り 躄り
いし	委し 慰し
いじめ	イジめ 苛め 虐め
いじめる	イジめる イジメる 苛める 虐める
いじら	イジら 弄ら
いじり	イジり 弄り
いじりたおし	いじり倒し 弄り倒し
いじりたおす	いじり倒す 弄り倒す
いじりまわさ	いじり回さ 弄り回さ
いじりまわし	いじり回し 弄りまわし 弄り回し
いじりまわす	いじり回す 弄り回す
いじる	イジる 弄る
いじれる	イジれる 弄れる
いすくめ	射すくめ 射竦め
いする	医する 委する
いすわっ	居すわっ 居座っ
いすわり	居すわり 居座り
いすわる	居すわる 居座る
いたおし	射倒し 射斃し
いたたまれ	居たたまれ 居た堪れ
いただい	戴い 頂い
いただか	戴か 頂か
いただき	いたゞき 戴き 頂き
いただく	いたゞく 戴く 頂く
いただけ	戴け 頂け
いただける	戴ける 頂ける
いただこう	戴こう 頂こう
いたっ	到っ 至っ 至ッ
いたぶる	甚振る 痛ぶる
いたま	傷ま 悼ま 痛ま
いたみ	傷み 悼み 痛み
いたむ	傷む 悼む 痛む
いため	イタめ 傷め 悼め 撓め 炒め 痛め
いためつけ	傷めつけ 痛めつけ 痛め付け
いためつける	傷めつける 痛めつける 痛め付ける
いためよう	傷めよう 痛めよう
いためる	傷める 撓める 炒める 痛める
いたら	到ら 至 至ら
いたり	到り 至 至り
いたりつく	到り着く 至り着く
いたる	到る 至 至る
いたれ	到れ 至れ
いたれる	到れる 至れる
いたわっ	労っ 労わっ
いたわら	労ら 労わら 慰ら
いたわり	労り 労わり
いたわりあい	いたわり合い 労わり合い
いたわる	労る 労わる
いたわれ	労れ 労われ
いたん	傷ん 悼ん 痛ん
いださ	出ださ 射出さ 鋳出さ
いだし	射出し 鋳出し
いだす	出だす 射出す 鋳出す
いっ	イっ 云っ 入っ 去っ 參っ 往っ 炒っ 煎っ 生っ 行っ 要っ 言っ 謂っ 逝っ
いっし	佚し 逸し
いつい	居つい 居付い 居着い 斎い
いつか	傅か 居つか 居付か 居着か 斎か
いつき	居つき 居付き 居着き 斎き
いつく	居つく 居付く 居着く 斎く
いつくしま	愛しま 慈しま
いつくしみ	愛しみ 慈しみ
いつくしむ	愛しむ 慈しむ
いつくしん	愛しん 慈しん
いつぶさ	鋳つぶさ 鋳潰さ
いつぶし	鋳つぶし 鋳潰し
いつぶす	鋳つぶす 鋳潰す
いつわっ	偽っ 偽わっ 詐っ
いつわら	偽ら 偽わら
いつわり	偽り 偽わり 詐り
いつわる	佯る 偽る
いてつい	凍てつい 凍て付い
いてつく	凍てつく 凍て付く
いでたち	いで立ち 出で立ち 出立ち
いでたっ	いで立っ 出で立っ
いでたつ	出で立つ 出立つ
いとなま	営なま 営ま
いとなみ	営なみ 営み
いとなむ	営なむ 営む
いとなん	営なん 営ん
いとめ	射とめ 射止め 射留め
いとめる	射とめる 射止める
いどみかかり	挑みかかり 挑み掛かり
いなし	去なし 往なし
いならぶ	居ならぶ 居並ぶ
いぬい	射ぬい 射抜い 射貫い
いぬか	射ぬか 射抜か 射貫か
いぬき	い抜き 射ぬき 射抜き 射貫き
いぬく	射ぬく 射抜く 射貫く
いのっ	祈っ 祷っ
いのら	祈ら 祷ら
いのり	祈り 祷り 禱り
いのる	祈る 祷る
いは	云は 言は 謂は
いはう	云はう 言はう 謂はう
いばりちらし	いばり散らし 威張りちらし 威張り散らし
いひ	云ひ 言ひ 謂ひ
いふ	云ふ 言ふ 謂ふ
いぶりださ	いぶり出さ 燻り出さ
いぶりだし	いぶり出し 燻り出し
いぶりだす	いぶり出す 燻り出す
いぶりだそう	いぶり出そう 燻り出そう
いへ	云へ 言へ
いましめ	戒め 縛め 誡め 警め
いましめる	戒める 縛める 誡める
いましめん	戒めん 誡めん
います	在す 坐す
いみきらう	忌みきらう 忌み嫌う
いみきらわ	忌み嫌わ 忌嫌わ
いや	言や 謂や
いやさ	癒さ 癒やさ
いやし	癒し 癒やし
いやしま	卑しま 賤しま
いやしみ	卑しみ 賤しみ
いやしむ	卑しむ 賎しむ 賤しむ
いやしめ	卑しめ 賎しめ 賤しめ
いやしん	卑しん 賤しん
いやす	癒す 癒やす
いやせ	癒せ 癒やせ
いやそう	癒そう 癒やそう
いやまし	いや増し 弥増し
いよ	射よ 居よ
いよう	射よう 居よう
いら	入ら 炒ら 煎ら 要ら
いらだた	いら立た 焦ら立た 苛立た
いらだち	いら立ち 苛立ち
いらだっ	いら立っ 苛だっ 苛立っ
いらだつ	いら立つ 焦立つ 苛立つ
いらつい	イラつい 苛つい
いらつか	イラつか 苛つか
いらつき	イラつき 苛つき
いり	入り 炒り 煎り 熬り 要り
いりくみ	入りくみ 入り組み 入組み
いりくん	いり組ん 入りくん 入り組ん 入組ん
いりつけ	炒り付け 煎りつけ 煎り付け
いりびたっ	入りびたっ 入り浸っ 入浸っ
いりびたり	入りびたり 入り浸り
いりびたる	入りびたる 入り浸る
いりまじっ	入りまじっ 入り交じっ 入り交っ 入り混じっ 入混じっ
いりまじり	いり交じり 入りまじり 入り交じり 入り混じり 入り雑じり
いりまじる	入りまじる 入り交じる 入り混じる
いりまぜ	入り交ぜ 入り混ぜ
いりみだれ	入りみだれ 入り乱れ
いりみだれる	入りみだれる 入り乱れる
いる	入る 射る 居る 炒る 煎る 熬る 要る 鋳る
いれ	入れ 容 容れ 射れ 居れ 挿れ 淹れ 炒れ 煎れ 納れ 要れ
いれあげ	入れあげ 入れ上げ 入れ揚げ
いれあげる	入れあげる 入れ上げる 入れ揚げる
いれかえ	入れかえ 入れ変え 入れ換え 入れ替え 入換え 入替え
いれかえる	入れかえる 入れ変える 入れ換える 入れ替える 入換える 入替える
いれかえれ	入れかえれ 入れ替えれ
いれかわっ	入れかわっ 入れ代わっ 入れ変わっ 入れ換わっ 入れ替っ 入れ替わっ 入替っ
いれかわり	入れかわり 入れ代り 入れ代わり 入れ変わり 入れ換わり 入れ替り 入れ替わり 入替り 入替わり
いれかわる	入れかわる 入れ代わる 入れ変わる 入れ換わる 入れ替る 入れ替わる 入替わる
いれこみ	入れ込み 入込み
いれこん	入れ込ん 入込ん
いれちがい	入れちがい 入れ違い
いれよ	入れよ 容れよ 居れよ
いれよう	入れよう 容れよう 挿れよう 淹れよう
いれる	入れる 容る 容れる 射れる 居れる 挿れる 淹れる 煎れる 納れる
いれれ	入れれ 容れれ
いろ	射ろ 居ろ
いろあせ	色あせ 色褪せ
いろあせる	色あせる 色褪せる
いろづい	色づい 色付い
いろづか	色づか 色付か
いろづき	色づき 色付き
いろづく	色づく 色付く
いろづけ	色づけ 色付け
いろどっ	彩っ 彩どっ
いろどり	彩どり 彩り
いわ	云わ 言わ 謂わ
いわさ	云わさ 言さ 言わさ
いわし	云わし 言し 言わし
いわす	云わす 言す 言わす
いん	射ん 居ん 忌ん
いんする	印する 因する 淫する
うえ	植え 樹え 種 飢え 餓え
うえかえ	植え代え 植え換え 植え替え
うえかえる	植えかえる 植え替える
うえこま	植えこま 植え込ま
うえこみ	植え込み 植込み
うえこむ	植えこむ 植え込む 植込む
うえこん	植えこん 植え込ん 植込ん
うえつけ	植えつけ 植え付け 植付け
うえつけよう	植えつけよう 植え付けよう
うえつける	植えつける 植え付ける 植付ける
うえる	植える 飢える 餓える
うえれ	植えれ 飢えれ
うかがい	伺い 窺い 覗い
うかがいしら	うかがい知ら 窺い知ら
うかがいしる	うかがい知る 伺い知る 窺いしる 窺い知る
うかがいしれ	うかがい知れ 窺いしれ 窺い知れ
うかがいしれよう	うかがい知れよう 窺い知れよう
うかがいしれる	うかがい知れる 伺い知れる 窺いしれる 窺い知れる
うかがいみる	うかがい見る 窺い見る
うかがう	伺う 窺う 覗う
うかがえ	伺え 窺え 窺がえ 覗え
うかがえよう	伺えよう 窺えよう
うかがえる	伺える 窺える
うかがおう	伺おう 窺おう
うかがっ	伺っ 窺がっ 窺っ 覗っ
うかがわ	伺わ 窺がわ 窺わ 覗わ
うかば	泛ば 浮かば 浮ば
うかび	泛び 浮かび 浮び
うかびあがっ	浮かびあがっ 浮かび上がっ
うかびあがら	浮かびあがら 浮かび上がら 浮びあがら 浮び上がら
うかびあがり	浮かびあがり 浮かび上がり 浮かび上り 浮びあがり
うかびあがる	浮かびあがる 浮かび上がる 浮かび上る 浮び上がる 浮び上る
うかびあがれ	浮かびあがれ 浮かび上がれ
うかぶ	泛ぶ 浮かぶ 浮ぶ
うかべ	泛べ 浮かべ 浮べ
うかべる	浮かべる 浮べる
うかれ	受かれ 浮かれ 浮れ
うかん	浮かん 浮ん
うきあがっ	浮きあがっ 浮き上がっ 浮き上っ
うきあがら	浮きあがら 浮き上がら 浮き上ら
うきあがり	浮きあがり 浮き上がり
うきあがる	浮きあがる 浮き上がる
うきあがれ	浮きあがれ 浮き上がれ
うきたち	うき立ち 浮き立ち
うきだし	浮きだし 浮き出し 浮出し
うきで	浮きで 浮き出 浮出
うけ	亨け 享け 受 受け 承け 浮け 請け
うけあい	受けあい 受け合い 請け合い 請合い
うけあう	受け合う 請け合う 請合う
うけあっ	受けあっ 受け合っ 請けあっ 請け合っ 請合っ
うけあわ	受けあわ 受け合わ 請け合わ 請合わ
うけいれ	受けいれ 受け入れ 受け容れ 受入れ 受容れ
うけいれよ	受けいれよ 受け入れよ
うけいれよう	受け入れよう 受け容れよう
うけいれる	うけ入れる 受けいれる 受け入れる 受け容れる 受入れる 受容れる
うけおう	請けおう 請け負う
うけおっ	受け負っ 請け負っ
うけおわ	うけ負わ 請け負わ
うけおわせ	請け負わせ 請負わせ
うけこたえる	受け応える 受け答える
うけたまわっ	受け賜っ 受け賜わっ 承っ 承わっ
うけたまわら	受け賜わら 承ら
うけださ	請け出さ 請出さ
うけつい	うけ継い 受けつい 受け継い 受継い 承けつい 承け継い
うけつが	うけ継が 受けつが 受け継が 受継が 承け継が
うけつぎ	受けつぎ 受け嗣ぎ 受け継ぎ 受継ぎ 承けつぎ 承け継ぎ
うけつぐ	受けつぐ 受け継ぐ 受継ぐ
うけつけ	受けつけ 受け付け 受付 受付け
うけつけよう	受けつけよう 受け付けよう 受付けよう
うけつける	受けつける 受け付ける 受付ける 受付る
うけとっ	受けとっ 受け取っ 受取っ 請け取っ
うけとめ	受けとめ 受け止め 受け留め 受止め
うけとめよう	受けとめよう 受け止めよう
うけとめる	受けとめる 受け止める 受け留める
うけとら	受けとら 受け取ら 受取ら
うけとり	受けとり 受け取り 受取り 請け取り
うけとる	うけ取 受けとる 受け取る 受取る 請け取る
うけとれ	受けとれ 受け取れ 受取れ 請け取れ
うけとれる	受けとれる 受け取れる 受取れる
うけとろう	受けとろう 受け取ろう 受取ろう
うけながし	うけ流し 受けながし 受け流し 受流し
うけもち	受けもち 受け持ち
うけもっ	受けもっ 受け持っ 受持っ
うけもつ	受けもつ 受け持つ 受持つ
うけよ	受けよ 受よ
うけよう	ウケよう 受けよう 請けよう
うける	ウケる 亨ける 享ける 受ける 受る 承ける 浮ける 請ける
うけれ	ウケれ 受けれ
うけわたし	受けわたし 受け渡し
うけわたす	受けわたす 受け渡す
うけん	ウケん 受けん
うごかす	動かす 揺す
うごきまわっ	動きまわっ 動き回っ 動き廻っ
うごきまわら	動きまわら 動き回ら
うごきまわり	動きまわり 動き回り
うごきまわる	動きまわる 動き回る
うごきまわれ	動きまわれ 動き回れ
うごきまわれる	動きまわれる 動き回れる
うしない	亡い 喪い 喪ない 失い 失ない
うしなう	喪う 喪なう 失う 失なう
うしなえ	喪え 失え 失なえ
うしなっ	亡っ 喪っ 失っ 失なっ
うしなは	喪は 失は
うしなふ	喪ふ 失ふ
うしなへ	喪へ 失へ
うしなわ	喪わ 失なわ 失わ
うすよごれ	うす汚れ 薄汚れ
うすれゆく	薄れゆく 薄れ行く
うずくまり	踞り 蹲り
うずくまる	踞る 蹲る
うずまい	うず巻い 渦まい 渦巻い
うずまき	うず巻き 渦まき 渦巻き
うずまく	うず巻く 渦まく 渦巻く
うた	伐た 射た 打た 拍た 搏た 撃た 撲た 討た
うたい	唄い 唱い 歌い 詠い 詩い 謡い 謳い
うたいあげ	歌いあげ 歌い上げ
うたいあげる	歌いあげる 歌い上げる
うたいおさめる	歌いおさめる 歌い収める
うたいおどっ	唄い踊っ 歌い踊っ
うたいおどら	唄い踊ら 歌い踊ら
うたいおどり	唄い踊り 歌い踊り
うたいおどる	唄い踊る 歌い踊る
うたいこま	うたい込ま 歌いこま 歌い込ま
うたいこみ	歌いこみ 歌い込み
うたいこむ	歌いこむ 歌い込む
うたいこん	歌いこん 歌い込ん
うたいださ	歌いださ 歌い出さ
うたいだし	うたい出し 歌いだし 歌い出し
うたいだす	歌いだす 歌い出す
うたいつい	歌いつい 歌い継い
うたいつが	歌いつが 歌い継が
うたいつぐ	うたい継ぐ 歌いつぐ 歌い継ぐ
うたいつごう	歌いつごう 歌い継ごう
うたいまわし	歌いまわし 歌い回し
うたいやめ	歌いやめ 歌い止め
うたう	ウタう 唄う 唱う 歌う 詠う 詩う 謠う 謡う 謳う
うたえ	唄え 唱え 歌え 詩え 謡え 謳え
うたえる	唄える 歌える 詠える 謡える 謳える
うたお	歌お 謡お
うたおう	唄おう 歌おう 詠おう 謡おう 謳おう
うたさ	打たさ 討たさ
うたし	打たし 撃たし 討たし
うたす	打たす 討たす
うたっ	ウタっ 唄っ 唱っ 歌っ 詠っ 詩っ 謡っ 謳っ
うたは	唄は 歌は
うたひ	唄ひ 歌ひ
うたふ	唄ふ 歌ふ
うたへ	唄へ 歌へ
うたわ	唄わ 唱わ 歌わ 詠わ 詩わ 謡わ 謳わ
うたわさ	唄わさ 歌わさ
うち	伐ち 射ち 打ち 拍ち 搏ち 撃ち 討ち
うちあい	打ちあい 打ち合い 撃ちあい 撃ち合い
うちあう	打ちあう 打ち合う 撃ちあう 撃ち合う
うちあえ	打ち合え 撃ち合え
うちあおう	打ち合おう 撃ち合おう
うちあがっ	打ちあがっ 打ち上がっ
うちあがら	打ちあがら 打ち上がら 打ち上ら
うちあがり	打ちあがり 打ち上がり
うちあがる	打ちあがる 打ち上がる 打ち上る
うちあけ	うち明け 打ちあけ 打ち明け 打明け
うちあけよう	打ち明けよう 打明けよう
うちあける	うち明ける 打ちあける 打ち明ける 打ち開ける
うちあげ	打ちあげ 打ち上げ 打ち揚げ 打上げ
うちあげる	打ちあげる 打ち上げる 打ち揚げる 打上げる
うちあっ	打ちあっ 打ち合っ 撃ちあっ 撃ち合っ
うちあわ	打ちあわ 打ち合わ
うちあわせ	打ちあわせ 打ち合わせ 打合せ 打合わせ
うちいっ	打ち入っ 討ち入っ
うちいり	打ち入り 討ち入り
うちいれ	打ち入れ 討ち入れ
うちいろう	打ち入ろう 討ち入ろう
うちおとさ	射ち落さ 打ち落さ 打ち落とさ 撃ち落さ 撃ち落とさ
うちおとし	打ちおとし 打ち落し 打ち落とし 打落し 撃ち墜とし 撃ち落し 撃ち落とし 討ち落とし
うちおとす	打ち落とす 撃ち落す 撃ち落とす 討ち落とす
うちおとせ	打ち落とせ 撃ち落せ 撃ち落とせ
うちおとせる	撃ち落せる 撃ち落とせる
うちおとそう	打ち落とそう 撃ち落そう 撃ち落とそう
うちおろし	打ちおろし 打ち下ろし 打ち降ろし 撃ち下ろし
うちおろす	打ちおろす 打ち下ろす 打ち降ろす 撃ち下ろす
うちおろせ	打ち下ろせ 撃ち下ろせ
うちかえ	打ちかえ 打ち変え 打ち替え
うちかえさ	打ち返さ 撃ち返さ
うちかえし	打ち返し 撃ちかえし 撃ち返し
うちかえす	打ち返す 打返す 撃ちかえす 撃ち返す
うちかえせ	打ち返せ 撃ち返せ
うちかえる	打ちかえる 打ち変える 打ち替える
うちかけ	打ち掛け 打ち欠け 撃ちかけ
うちかち	打ち克ち 打ち勝ち 打克ち
うちかっ	打ち克っ 打ち勝っ
うちかつ	うち勝つ 打ち克つ 打ち勝つ
うちかて	打ち克て 打ち勝て
うちかとう	打ち克とう 打ち勝とう
うちきっ	打ちきっ 打ち切っ 打切っ
うちきら	うち切ら 打ちきら 打ち切ら 打切ら
うちきり	うち切り 打ちきり 打ち切り 打切り
うちきる	うち切る 打ちきる 打ち切る 打切る
うちきれ	打ち切れ 打切れ
うちくずし	打ち崩し 撃ち崩し
うちくずす	打ち崩す 撃ち崩す
うちくだい	打ち砕い 撃ち砕い
うちくだか	打ちくだか 打ち砕か 撃ち砕か
うちくだく	打ち砕く 撃ち砕く
うちけし	うち消し 打ち消し 打消し
うちけす	うち消す 打ち消す
うちこま	打ちこま 打ち込ま 打込ま 撃ちこま 撃ち込ま
うちこみ	打ちこみ 打ち込み 打込み 撃ちこみ 撃ち込み
うちこむ	打ちこむ 打ち込む 打込む 撃ちこむ 撃ち込む
うちこめ	打ちこめ 打ち込め 打込め 撃ちこめ 撃ち込め
うちこめる	打ち込める 撃ち込める
うちこめれ	打ち込めれ 撃ち込めれ
うちこもう	打ちこもう 打ち込もう 撃ち込もう
うちころさ	射ち殺さ 打ち殺さ 打殺さ 撃ち殺さ 撃殺さ
うちころし	射ち殺し 打ち殺し 打殺し 撃ち殺し 撃殺し 討ち殺し
うちころす	射ち殺す 打ち殺す 撃ち殺す 討ち殺す
うちころせ	打ち殺せ 撃ち殺せ 撃殺せ
うちころそう	打ち殺そう 撃ち殺そう
うちこわさ	打ちこわさ 撃ち壊さ
うちこわし	打ちこわし 撃ち壊し
うちこわす	打ちこわす 撃ち壊す
うちこん	打ちこん 打ち込ん 打込ん 撃ちこん 撃ち込ん
うちしおれ	うち萎れ 打ちしおれ
うちしずん	うち沈ん 打ち沈ん
うちすえ	打ちすえ 打ち据え
うちすえる	打ちすえる 打ち据える
うちすて	うち捨て 打ちすて 打ち捨て 打ち棄て 打捨て
うちすてよ	打ち捨てよ 打ち棄てよ
うちすてる	うち捨てる 打ち捨てる
うちたおさ	打ち倒さ 撃ち倒さ 討ち倒さ
うちたおし	打ち倒し 撃ちたおし 撃ち倒し 討ち倒し
うちたおす	打ち倒す 撃ちたおす 撃ち倒す 討ち倒す
うちたおせ	打ち倒せ 打倒せ
うちたおそう	打ち倒そう 討ち倒そう
うちたたい	打ちたたい 打ち叩い
うちたたく	打ちたたく 打ち叩く
うちたて	うち建て うち立て 打ちたて 打ち建て 打ち樹て 打ち立て 打建て 打立て
うちたてよう	うち立てよう 打ちたてよう 打ち建てよう 打ち立てよう
うちたてる	うち立てる 打ちたてる 打ち建てる 打ち樹てる 打ち立てる 打建てる
うちださ	うち出さ 打ちださ 打ち出さ 打出さ 撃ち出さ
うちだし	うち出し 打ちだし 打ち出し 打出し 撃ち出し
うちだす	うち出す 打ちだす 打ち出す 打出す 撃ち出す
うちだせ	打ち出せ 撃ち出せ
うちだせる	打ちだせる 打ち出せる
うちつが	打ち継が 打継が
うちつけ	打ちつけ 打ち付け 打付け
うちつける	打ちつける 打ち付ける 打ち突ける
うちつづい	うち続い 打ち続い
うちつづき	うち続き 打ち続き 打続き
うちつづく	うち続く 打ちつづく 打ち続く
うちつぶさ	打ちつぶさ 打ち潰さ
うちつれ	打ちつれ 打ち連れ
うちとおし	打ち通し 打通し
うちとけ	うち解け 打ちとけ 打ち解け 打解け
うちとける	うち解ける 打ち解ける
うちとっ	打ちとっ 打ち取っ 打取っ 撃ち取っ 討ちとっ 討ち取っ 討取っ
うちとめ	打ちとめ 打ち止め 撃ちとめ 撃ち止め
うちとめる	打ち止める 撃ち止める
うちとら	打ちとら 打ち取ら 撃ち取ら 討ちとら 討ち取ら 討取ら
うちとり	うち取り 打ちとり 打ち取り 撃ち取り 討ちとり 討ち取り 討取り
うちとる	打ちとる 打ち取る 撃ち取る 討ちとる 討ち取る 討取る
うちとれ	打ちとれ 打ち取れ 討ちとれ 討ち取れ 討取れ
うちとれる	打ち取れる 討ち取れる
うちとろう	打ち取ろう 討ち取ろう 討取ろう
うちならさ	打ち鳴らさ 打鳴らさ 撃ち鳴らさ
うちならし	打ちならし 打ち鳴らし 打鳴らし 撃ち鳴らし
うちならす	打ちならす 打ち鳴らす 撃ち鳴らす
うちぬい	打ちぬい 打ち抜い 打抜い 撃ちぬい 撃ち抜い
うちぬか	打ちぬか 打ち抜か 撃ちぬか 撃ち抜か
うちぬき	打ち抜き 撃ちぬき 撃ち抜き
うちぬく	打ちぬく 打ち抜く 撃ちぬく 撃ち抜く
うちぬけ	打ち抜け 撃ち抜け
うちはなし	打ち放し 撃ち放し
うちはなっ	撃ちはなっ 撃ち放っ
うちはなつ	打ち放つ 撃ち放つ
うちはらい	打ち払い 打払い 討ち払い
うちはらう	打ち払う 打払う 撃ち払う 討ち払う
うちはらえ	打ち払え 撃ち払え
うちはらっ	打ち払っ 撃ち払っ 討ち払っ
うちはらわ	打ち払わ 撃ち払わ
うちひしが	打ちひしが 打ち拉が
うちふる	打ちふる 打ち振る
うちへらさ	打ち減らさ 討ち減らさ
うちほろぼさ	打ち滅ぼさ 討ち滅ぼさ
うちほろぼし	打ち滅ぼし 討ち滅ぼし
うちほろぼす	打ち滅ぼす 討ち亡ぼす 討ち滅す 討ち滅ぼす
うちほろぼそう	打ち滅ぼそう 討ち滅ぼそう
うちまかし	うち負かし 打ち負かし
うちもらし	打ち漏らし 撃ちもらし 撃ち漏らし 討ちもらし
うちもらす	打ち漏らす 撃ちもらす 撃ち漏らす
うちやぶっ	うち破っ 打ち破っ 打破っ 撃ち破っ 討ち破っ
うちやぶら	うち破ら 打ち破ら 打破ら 撃ち破ら 討ち破ら
うちやぶり	うち破り 打ち破り 打破り 撃ち破り 撃破り 討ち破り
うちやぶる	うち破る 打ち破る 撃ち破る 討ち破る
うちやぶれ	打ちやぶれ 打ち破れ 撃ち破れ
うちやぶれる	打ち破れる 撃ち破れる
うちやぶろう	打ち破ろう 討ち破ろう
うちよせ	うち寄せ 打ち寄せ 打寄せ
うちよせる	打ちよせる 打ち寄せる
うっ	売っ 射っ 打っ 拍っ 撃っ 撲っ 討っ 賣っ
うったえ	訴 訴え
うったえかけ	訴えかけ 訴え掛け
うったえかける	訴えかける 訴え掛ける
うったえる	訴える 訴る
うつ	伐つ 射つ 打つ 拍つ 搏つ 撃つ 撲つ 討つ
うつさ	写さ 撮さ 映さ 移さ 遷さ
うつし	写し 撮し 映し 移し 遷し
うつしかえ	写し換え 移しかえ 移し変え 移し換え 移し替え
うつしかえよう	移し変えよう 移し替えよう
うつしかえる	写し換える 移しかえる 移し変える 移し換える 移し替える
うつしかえれ	移し変えれ 移し替えれ
うつしこま	写し込ま 映し込ま
うつしこむ	写し込む 映し込む
うつしこん	写し込ん 映し込ん
うつしださ	うつし出さ 写しださ 写し出さ 映しださ 映し出さ
うつしだし	うつし出し 写しだし 写し出し 映しだし 映し出し
うつしだす	写しだす 写し出す 映しだす 映し出す
うつしだせ	写し出せ 映し出せ
うつしだせる	写し出せる 映し出せる
うつしだそう	映しだそう 映し出そう
うつしとっ	写しとっ 写し取っ 映し取っ
うつしとら	写しとら 写し取ら 移し取ら
うつしとり	写しとり 写し取り 移し取り
うつしとる	写しとる 写し取る 映し取る 移し取る
うつしとろう	写しとろう 写し取ろう
うつす	写す 映す 移す 遷す
うつせ	写せ 寫せ 映せ 移せ 遷せ
うつせる	写せる 映せる 移せる
うつそう	写そう 映そう 移そう 遷そう
うつっ	写っ 感染っ 憑っ 映っ 移っ 遷っ
うつぶし	うつ伏し 俯し
うつぶす	うつ伏す 俯す
うつぶせ	うつ伏せ 俯せ
うつむい	うつ向い 俯い
うつむき	うつ向き 俯き
うつむけ	うつ向け 俯け
うつら	写ら 憑ら 映ら 移ら 遷ら
うつり	写り 憑り 映り 移り 遷り
うつりかわっ	移りかわっ 移り変っ 移り変わっ
うつりかわり	うつり変わり 移りかわり 移り変り 移り変わり 遷り変わり
うつりかわる	移りかわる 移り変る 移り変わる 遷り変わる
うつりこま	写りこま 写り込ま 映りこま 映り込ま
うつりこみ	写りこみ 写り込み 映りこみ 映り込み
うつりこむ	写りこむ 写り込む 映りこむ 映り込む 移り込む
うつりこもう	写り込もう 映り込もう
うつりこん	写りこん 写り込ん 映りこん 映り込ん 移り込ん
うつりすみ	移りすみ 移り住み
うつりすむ	移りすむ 移り住む
うつりすん	移りすん 移り住ん
うつる	写る 感染る 映る 移る 移ル 遷る
うつれ	写れ 映れ 移れ 遷れ
うつれる	写れる 映れる 移れる
うつろ	移ろ 遷ろ
うつろう	写ろう 映ろう 移ろう 遷ろう
うて	伐て 射て 打て 拍て 撃て 討て
うてる	打てる 撃てる 討てる
うてれ	打てれ 撃てれ 討てれ
うと	射と 打と 拍と 討と
うとう	唄う 射とう 打とう 撃とう 歌う 討とう 謡う
うとふ	唱ふ 詠ふ 謡ふ
うながさ	促がさ 促さ
うながし	促がし 促し
うながす	促がす 促す
うなずい	肯い 頷い
うなずか	肯か 頷か
うなずき	肯き 頷き
うなずく	肯く 頷く
うなずけ	肯け 頷け
うなずける	肯ける 頷ける
うなだれ	うな垂れ 項垂れ
うなだれる	うな垂れる 項垂れる
うなり	呻り 唸り
うぬぼれ	己惚れ 自惚れ
うばいあい	奪いあい 奪い合い
うばいあう	奪いあう 奪い合う
うばいあっ	奪いあっ 奪い合っ
うばいかえさ	奪いかえさ 奪い返さ 奪い還さ
うばいかえし	奪いかえし 奪い返し
うばいかえす	奪いかえす 奪い返す
うばいかえせ	奪いかえせ 奪い返せ
うばいさっ	奪いさっ 奪い去っ
うばいさら	奪いさら 奪い去ら
うばいさり	奪いさり 奪い去り
うばいさる	奪いさる 奪い去る
うばいさろう	奪いさろう 奪い去ろう
うばいとっ	奪いとっ 奪い取っ 奪い盗っ
うばいとら	奪いとら 奪い取ら
うばいとり	奪いとり 奪い取り 奪ひ取り
うばいとる	奪いとる 奪い取る 奪い獲る
うばいとれ	うばい取れ 奪いとれ 奪い取れ
うばいとろう	奪いとろう 奪い取ろう 奪い盗ろう
うばう	奪う 簒う
うま	倦ま 熟ま 生ま 産ま
うまっ	埋っ 埋まっ
うまら	埋まら 埋ら
うまり	埋まり 埋り
うまる	埋まる 埋る
うまれ	埋まれ 生まれ 生れ 産まれ 産れ
うまれおち	生まれ落ち 生れ落ち 産まれ落ち
うまれおちる	生まれ落ちる 生れ落ちる 産まれ落ちる
うまれかわっ	生まれかわっ 生まれ代わっ 生まれ変っ 生まれ変わっ 生れ変っ 生れ変わっ
うまれかわら	生まれかわら 生まれ変わら 生れ変ら
うまれかわり	生まれかわり 生まれ代わり 生まれ変り 生まれ変わり 生れ変り 生れ変わり
うまれかわる	生まれかわる 生まれ変る 生まれ変わる 生れかわる 生れ変わる
うまれかわれ	生まれかわれ 生まれ変われ
うまれかわれる	生まれかわれる 生まれ変われる
うまれかわろう	生まれ変わろう 生れかわろう
うまれそだっ	生まれ育っ 生れ育っ
うまれそだつ	生まれ育つ 生れ育つ
うまれつい	生まれつい 生まれ付い 生れつい
うまれつき	生まれつき 生れつき
うまれつく	生まれつく 生れつく
うまれで	生まれで 生まれ出 生れ出 産まれ出
うまれでる	生まれ出る 生れ出る 産まれ出る
うまれもっ	生まれもっ 生まれ持っ
うまれもつ	生まれもつ 生まれ持つ
うまれよ	生まれよ 生れよ
うまれよう	生まれよう 生れよう 産まれよう
うまれる	生まれる 生れる 産まれる 産れる
うみ	倦み 生み 産み 績み 膿み
うみおとさ	生み落さ 生み落とさ 産みおとさ 産み落とさ
うみおとし	生み落し 生み落とし 産みおとし 産み落し 産み落とし
うみおとす	産みおとす 産み落とす
うみそだて	生み育て 産み育て
うみそだてる	生み育てる 産み育てる
うみださ	うみ出さ 生みださ 生み出さ 産みださ 産み出さ
うみだし	生みだし 生み出し 産みだし 産み出し
うみだす	うみ出す 生みだす 生み出す 産みだす 産み出す
うみだせ	生みだせ 生み出せ 産み出せ
うみだせる	生みだせる 生み出せる
うみだそう	生みだそう 生み出そう 産み出そう
うみつけ	生みつけ 生み付け 産みつけ 産み付け
うみつける	生みつける 生み付ける 産みつける 産み付ける
うみなさ	生みなさ 生み成さ
うみのこし	生み残し 産み残し
うみわける	生み分ける 産み分ける
うむ	倦む 熟む 生む 産む 績む 膿む
うめ	埋め 生め 産め
うめあわせ	埋め合せ 埋め合わせ 埋合せ
うめあわせる	埋めあわせる 埋め合わせる 埋合せる
うめき	呻き 呻めき
うめこま	埋めこま 埋め込ま 埋込ま
うめこみ	埋めこみ 埋め込み 埋込み
うめこむ	埋めこむ 埋め込む 埋込む
うめこめ	埋め込め 埋込め
うめこん	埋めこん 埋め込ん 埋込ん
うめたて	埋めたて 埋め立て 埋立て
うめたてよう	埋め立てよう 埋立てよう
うめたてる	埋め立てる 埋立てる
うめもどさ	埋め戻さ 埋戻さ
うめもどし	埋めもどし 埋め戻し 埋戻し
うめよ	埋めよ 生めよ 産めよ
うめる	埋める 生める 産める
うめん	埋めん 産めん
うもう	生もう 産もう
うもれ	埋もれ 埋れ
うもれる	埋もれる 埋れる
うら	売ら 賣ら
うらぎっ	裏ぎっ 裏切っ
うらぎら	裏ぎら 裏切ら
うらづけ	裏づけ 裏付け
うらづけよう	裏づけよう 裏付けよう
うらづける	裏づける 裏付ける
うらない	卜い 占い
うらなっ	卜っ 占っ
うらま	怨ま 恨ま
うらみ	怨み 恨み 憾み
うらむ	怨む 恨む 憾む
うらん	怨ん 恨ん 憾ん
うりあげ	売りあげ 売り上げ 売上げ
うりあげる	売りあげる 売り上げる 売上げる
うりあげれ	売りあげれ 売り上げれ
うりきれ	売りきれ 売り切れ 売切れ
うりきれる	売りきれる 売り切れる 売切れる
うりこま	売りこま 売り込ま
うりこみ	売りこみ 売り込み 売込み
うりこむ	売りこむ 売り込む 売込む
うりこもう	売りこもう 売り込もう
うりこん	売りこん 売り込ん 売込ん
うりさばい	売りさばい 売り捌い
うりさばか	売りさばか 売り捌か 売捌か
うりさばき	売さばき 売りさばき 売り捌き 売捌き
うりさばく	売りさばく 売り捌く 売捌く
うりさばける	売りさばける 売り捌ける
うりさばこう	売りさばこう 売り捌こう
うりださ	売り出さ 売出さ
うりだし	売り出し 売出し
うりだす	売り出す 売出す
うりだせ	売り出せ 売出せ
うりつけ	売りつけ 売り付け 売付け
うりつけよう	売りつけよう 売り付けよう
うりつける	売りつける 売り付ける
うりつなぐ	売りつなぐ 売り繋ぐ
うりとばさ	売りとばさ 売り飛ばさ
うりとばし	売りとばし 売り飛ばし
うりとばす	売りとばす 売り飛ばす
うりぬけ	売りぬけ 売り抜け
うりはらい	売り払い 売払い
うりはらっ	売りはらっ 売り払っ 売払っ
うりはらわ	売り払わ 売払わ
うりもどし	売り戻し 売戻し
うりわたさ	売り渡さ 売渡さ
うりわたし	売りわたし 売り渡し 売渡し
うりわたす	売りわたす 売り渡す 売渡す
うる	売る 得る 獲る 賣る
うるおし	潤おし 潤し
うるおす	潤おす 潤す
うれ	売れ 熟れ
うれえ	愁え 憂え
うれる	売れる 熟れる
うろつい	ウロつい 彷徨い
うろつき	ウロつき 彷徨き
うわずり	上ずり 上擦り
うわずる	上ずる 上擦る
うわっ	植っ 植わっ
うわつい	浮つい 浮わつい
うわつく	浮つく 浮わつく
うわまわっ	上まわっ 上回っ 上廻っ
うわまわら	上まわら 上回ら
うわまわり	上まわり 上回り 上回わり
うわまわる	上まわる 上回る 上回わる 上廻る
うん	倦ん 生ん 産ん 績ん 膿ん
え	得 獲
えいじ	映じ 詠じ
えいじる	映じる 詠じる
えいずる	映ずる 詠ずる
えがい	描い 画い 畫い
えがか	描か 画か
えがき	描き 画き
えがきこま	描きこま 描き込ま
えがきこみ	描きこみ 描き込み
えがきこむ	描きこむ 描き込む
えがきこん	描きこん 描き込ん
えがきださ	描きださ 描き出さ
えがきだし	えがき出し 描きだし 描き出し
えがきだす	描きだす 描き出す 画き出す
えがきだそう	描きだそう 描き出そう
えがきわけ	描きわけ 描き分け
えがきわけよう	描きわけよう 描き分けよう
えがく	描く 画く 畫く
えがけ	描け 画け
えがける	描ける 画ける
えがこう	描こう 画こう
えきし	役し 益し
えきする	役する 益する
えぐら	エグら 刳ら
えぐり	エグり 刳り
えぐりださ	えぐり出さ 刳り出さ 抉りださ 抉り出さ
えぐりだし	えぐり出し 抉りだし 抉り出し
えぐりだす	えぐり出す 抉りだす 抉り出す
えぐりとっ	えぐり取っ 刳り取っ 抉り取っ
えぐりとら	えぐり取ら 抉り取ら
えぐりとり	えぐり取り 抉り取り
えぐりとる	えぐり取る 抉り取る
えっし	謁し 閲し
えっする	謁する 閲する
えよう	得よう 獲よう
えらば	択ば 選ば 選らば
えらび	択び 選び
えらびださ	選びださ 選び出さ
えらびだし	選びだし 選び出し
えらびだす	選びだす 選び出す
えらびだせ	選びだせ 選び出せ
えらびとっ	選びとっ 選び取っ
えらびとり	選びとり 選び取り
えらびとる	選びとる 選び取る
えらびぬい	選びぬい 選び抜い
えらびぬか	選びぬか 選び抜か
えらびぬく	選びぬく 選び抜く
えらぶ	択ぶ 選ぶ 選らぶ
えらん	択ん 選らん 選ん
えりこのむ	選り好 選り好む
えりぬい	えり抜い 選り抜い
える	得る 得ル 獲る 選る
えれ	得れ 選れ
えん	得ん 笑ん
えんじわけ	演じわけ 演じ分け
えんじわける	演じわける 演じ分ける
えんづい	縁づい 縁付い
えんづか	縁づか 縁付か
えんづく	縁づく 縁付く
えんづけ	縁づけ 縁付 縁付け
おい	擱い 於い 置い 老い 負い 追い 逐い
おいあげ	追いあげ 追い上げ
おいあげる	追いあげる 追い上げる
おいうち	追い打ち 追い討ち
おいおとさ	追い落さ 追い落とさ
おいおとし	追い落し 追い落とし
おいおとす	追い落す 追い落とす
おいおとそう	追い落そう 追い落とそう
おいかえさ	追い帰さ 追い返さ
おいかえし	追い帰し 追い返し
おいかえす	追いかえす 追い帰す 追い返す
おいかえせ	追いかえせ 追い返せ
おいかえそう	追い帰そう 追い返そう
おいかけ	追いかけ 追い掛け 追い駆け 追掛け
おいかけよう	追いかけよう 追い掛けよう
おいかける	追いかける 追い掛ける 追い駆ける 追掛ける
おいこさ	追い越さ 追越さ
おいこし	追いこし 追い越し 追越し
おいこす	追い越す 追越す
おいこそう	追い越そう 追越そう
おいこま	追いこま 追い込ま 追込ま
おいこみ	追いこみ 追い込み 追込み
おいこむ	追いこむ 追い込む
おいこめ	追いこめ 追い込め
おいこもう	追いこもう 追い込もう
おいこん	老い込ん 追いこん 追い込ん
おいしげっ	おい茂っ 生い繁っ 生い茂っ
おいしげり	生い繁り 生い茂り 生茂り
おいしげる	おい茂る 生い繁る 生い茂る 生茂る
おいすがっ	追いすがっ 追い縋っ
おいすがる	追いすがる 追い縋る
おいすがろう	追いすがろう 追い縋ろう
おいたた	生いたた 生い立た
おいたて	生いたて 生い立て 追いたて 追い立て 追ひ立て 追立て
おいたてる	追いたてる 追い立てる
おいださ	追いださ 追い出さ
おいだし	追いだし 追い出し 追出し
おいだす	追いだす 追い出す 追出す
おいだせ	追い出せ 追出せ
おいだそう	追いだそう 追い出そう
おいつい	追いつい 追い付い 追い着い 追付い
おいつか	追いつか 追い付か 追い着か 追付か
おいつき	追いつき 追い付き 追い着き 追付き
おいつく	追いつく 追い付く 追い着く 追付く
おいつけ	追いつけ 追い付け 追付け
おいつける	追いつける 追い付ける
おいつこう	追いつこう 追い付こう
おいつめ	追いつめ 追い詰め 追ひつめ 追詰め
おいつめよう	追いつめよう 追い詰めよう
おいつめる	追いつめる 追い詰める
おいで	生い出 追い出
おいぬい	追いぬい 追い抜い 追抜い
おいぬか	追いぬか 追い抜か
おいぬき	追い抜き 追抜き
おいはなし	追い放し 追放し
おいはらい	追いはらい 追い払い
おいはらう	追いはらう 追い払う
おいはらっ	追いはらっ 追い払っ 追払っ
おいぼれ	老いぼれ 老い耄れ
おいまわさ	追いまわさ 追い回さ 追い廻さ 追廻さ
おいまわし	追いまわし 追い回し 追い廻し 追回し 追廻し
おいまわす	追いまわす 追い回す 追回す 追廻す
おいもとめ	追いもとめ 追い求め
おいもとめる	追いもとめる 追い求める
おいやっ	追いやっ 追い遣っ
おいやら	追いやら 追い遣ら 追ひやら
おいやり	追いやり 追い遣り
おいやる	追いやる 追い遣る
おいやろう	追いやろう 追い遣ろう
おう	会う 負う 追う 逐う 逢う 遭う
おうじ	応じ 應じ
おえ	卒え 終え 負え 追え 逐え
おえる	了える 卒える 終える 負える 追える
おおい	掩い 蓋い 蔽い 被い 覆い
おおいかくさ	覆いかくさ 覆い隠さ
おおいかくし	おおい隠し 覆いかくし 覆い隠し
おおいかくす	おおい隠す 覆いかくす 覆い隠す
おおいかぶさっ	覆いかぶさっ 覆い被さっ
おおいかぶさり	覆いかぶさり 覆い被さり
おおいかぶさる	被いかぶさる 覆いかぶさる 覆い被さる
おおいかぶされ	覆いかぶされ 覆い被され
おおいかぶせ	覆いかぶせ 覆い被せ
おおいかぶせる	覆いかぶせる 覆い被せる
おおう	掩う 蓋う 蔽う 被う 覆う 負おう 追おう
おおえる	被える 覆える
おおせ	仰せ 果せ 遂せ
おおせつかっ	仰せつかっ 仰せ付かっ
おおせつかり	仰せつかり 仰せ付かり
おおせつかる	仰せつかる 仰せ付かる
おおせつけ	仰せつけ 仰せ付け
おおせる	果せる 遂せる
おおっ	掩っ 蓋っ 蔽っ 被っ 覆っ
おおふ	蓋ふ 蔽ふ 被ふ 覆ふ
おおわ	掩わ 蓋わ 蔽わ 被わ 覆わ
おか	於か 置か
おかさ	侵さ 冒さ 犯さ 置かさ
おかし	侵し 冐し 冒し 犯し 置かし
おかす	侵す 冒す 犯す
おかせ	侵せ 冒 冒せ 犯せ
おかせる	冒せる 犯せる
おかそう	侵そう 冒そう 犯そう
おがみ	をがみ 拝み
おがむ	をがむ 拝む
おき	於 於き 置き 起き
おきあがっ	起きあがっ 起き上がっ 起き上っ
おきあがら	起きあがら 起き上がら
おきあがり	起きあがり 起き上がり 起き上り 起上り
おきあがる	起きあがる 起き上がる
おきあがれ	起きあがれ 起き上がれ
おきあがれる	起きあがれる 起き上がれる 起き上れる
おきかえ	おき換え 置きかえ 置き代え 置き変え 置き換え 置き替え 置換え
おきかえよう	置きかえよう 置き変えよう 置き換えよう
おきかえる	置きかえる 置き代える 置き変える 置き換える 置き替える 置換える
おきかえれ	置きかえれ 置き換えれ 置き替えれ
おきかわっ	置きかわっ 置き変わっ 置き換わっ 置き替わっ
おきかわり	置き変わり 置き換わり 置き替わり
おきかわる	置きかわる 置き変わる 置き換わる 置き替わる
おきかわれ	置き変われ 置き換われ
おきさら	おき去ら 置き去ら
おぎないあい	補いあい 補い合い
おぎないあう	補いあう 補い合う
おぎないあっ	補いあっ 補い合っ
おぎなえ	補 補え
おぎなえる	補える 補る
おぎなおう	補おう 補なおう
おぎなっ	補っ 補なっ
おぎなわ	補なわ 補わ
おく	擱く 於 於く 置く 送
おくっ	贈っ 送っ
おくら	贈ら 送ら
おくらさ	送らさ 遅らさ
おくらせ	後らせ 遅らせ
おくり	贈り 送り
おくりあい	送りあい 送り合い
おくりあう	送りあう 送り合う
おくりあっ	送りあっ 送り合っ
おくりかえさ	送りかえさ 送り帰さ 送り返さ
おくりかえし	送り帰し 送り返し 送り還し
おくりかえす	送りかえす 送り帰す 送り返す 送り還す
おくりかえそう	送り帰そう 送り返そう
おくりこま	送りこま 送り込ま
おくりこみ	送りこみ 送り込み 送込み
おくりこむ	送りこむ 送り込む
おくりこめ	送りこめ 送り込め
おくりこもう	送りこもう 送り込もう
おくりこん	送りこん 送り込ん
おくりださ	送りださ 送り出さ 送出さ
おくりだし	送りだし 送り出し 送出し
おくりだす	送りだす 送り出す
おくりだそう	送りだそう 送り出そう
おくりつけ	送りつけ 送り付け
おくりつける	送りつける 送り付ける
おくりとどけ	おくり届け 贈り届け 送りとどけ 送り届け
おくりとどける	贈り届ける 送りとどける 送り届ける
おくる	贈る 送る
おくれ	後れ 贈れ 送れ 遅れ
おくれる	後れる 贈れる 送れる 遅れる
おくろう	贈ろう 送ろう
おけ	於 於け 置 置け
おける	置ける 置る
おこさ	熾さ 興さ 起こさ 起さ
おこし	熾し 興し 起こし 起し
おこす	熾す 興す 起こす 起す
おこせ	興せ 起こせ 起せ
おこせる	興せる 起こせる 起せる
おこそう	興そう 起こそう 起そう
おこたっ	怠たっ 怠っ
おこたり	怠たり 怠り
おこっ	怒っ 熾っ 興っ 起こっ 起っ
おこない	行い 行ない
おこなう	行う 行なう
おこなえ	行え 行なえ
おこなえる	行える 行なえる
おこなおう	行おう 行なおう
おこなっ	行っ 行なっ
おこなわ	行なわ 行わ
おこなわさ	行なわさ 行わさ
おこら	怒ら 興ら 起こら 起ら
おこり	怒り 熾り 興り 起こり 起り
おこる	怒る 興る 起こる 起る
おこれ	怒れ 興れ 起これ 起れ
おころう	怒ろう 興ろう 起ころう
おこん	怒ん 起こん
おごっ	傲っ 奢っ 驕っ
おごら	奢ら 驕ら
おごり	傲り 奢り 驕り
おごりたかぶっ	おごり高ぶっ 驕りたかぶっ 驕り高ぶっ
おごりたかぶり	おごり高ぶり 驕り高ぶり
おごりたかぶる	おごり高ぶる 驕りたかぶる 驕り高ぶる
おごる	傲る 奢る 驕る
おごれる	傲れる 奢れる 驕れる
おさ	圧さ 押さ 捺さ 推さ
おさえ	オサえ 圧え 抑え 抑さえ 押え 押さえ
おさえこま	抑えこま 抑え込ま 押え込ま 押さえこま 押さえ込ま
おさえこみ	抑えこみ 抑え込み 押さえこみ 押さえ込み
おさえこむ	抑えこむ 抑え込む 押さえこむ 押さえ込む
おさえこめ	抑え込め 押さえこめ 押さえ込め
おさえこめる	抑え込める 押さえ込める
おさえこもう	抑えこもう 抑え込もう 押さえ込もう
おさえこん	抑えこん 抑え込ん 押え込ん 押さえこん 押さえ込ん
おさえつけ	抑えつけ 抑え付け 押えつけ 押え付け 押さえつけ 押さえ付け
おさえつけよう	抑えつけよう 抑え付けよう 押さえつけよう
おさえつける	抑えつける 抑え付ける 押えつける 押さえつける 押さえ付ける
おさえつけれ	抑えつけれ 押さえつけれ
おさえよ	抑えよ 押さえよ
おさえよう	抑えよう 押えよう 押さえよう
おさえる	オサえる オサエる 圧える 抑える 押える 押さえる
おさえれ	オサエれ 抑えれ 押さえれ
おさまっ	修まっ 収っ 収まっ 治まっ 納まっ
おさまら	修まら 収まら 収ら 治まら 納まら
おさまり	修まり 収まり 治まり 納まり
おさまる	修まる 収まる 収る 治まる 納まる
おさまれ	収まれ 治まれ
おさまろう	収まろう 納まろう
おさめ	修め 収め 收め 治め 納 納め 蔵め
おさめよ	修めよ 収めよ 治めよ 納めよ
おさめよう	修めよう 収めよう 治めよう 納めよう
おさめる	修める 収める 治める 納める 納る
おさめれ	修めれ 収めれ 治めれ 納めれ
おさめろ	修めろ 収めろ 治めろ
おさめん	修めん 収めん 治めん
おし	圧し 押し 捺し 推し
おしあい	押しあい 押し合い
おしあう	押しあう 押し合う
おしあがっ	押しあがっ 押し上がっ
おしあけ	おし開け 押し開け
おしあげ	押しあげ 押し上げ 押上げ
おしあげよう	押し上げよう 推し上げよう
おしあげる	押しあげる 押し上げる 押上げる 推し上げる
おしあっ	押しあっ 押し合っ
おしあて	押しあて 押し当て
おしあてる	押しあてる 押し当てる
おしいただい	押し戴い 押し頂い
おしいただき	おし頂き 押し戴き 押し頂き
おしいただく	押し戴く 押し頂く
おしいっ	押しいっ 押し入っ 押入っ
おしいり	押し入り 押入り
おしいる	押し入る 押入る
おしえ	教 教え 教へ 訓え
おしえあい	教えあい 教え合い
おしえあう	教えあう 教え合う
おしえあっ	教えあっ 教え合っ
おしえこま	教えこま 教え込ま
おしえこみ	教えこみ 教え込み
おしえこむ	教えこむ 教え込む
おしえこもう	教えこもう 教え込もう
おしえこん	教えこん 教え込ん
おしえさとし	教えさとし 教え諭し
おしえさとす	教えさとす 教え諭す
おしえよ	教えよ 教へよ
おしえる	教える 教へる 教る
おしおよぼし	押し及ぼし 推し及ぼし
おしかえし	押しかえし 押し返し
おしかくし	おし隠し 押し隠し
おしかけ	押しかけ 押し掛け
おしかけよう	押しかけよう 押し掛けよう
おしかける	押しかける 押し掛ける
おしかためる	押しかためる 押し固める 押し堅める
おしかぶせ	押しかぶせ 押し被せ
おしきっ	押しきっ 押し切っ 押切っ
おしきら	押しきら 押し切ら 押切ら
おしきり	押しきり 押し切り 押切り
おしきる	押し切る 押切る
おしこま	押しこま 押し込ま 押込ま
おしこみ	押しこみ 押し込み 押込み
おしこむ	押しこむ 押し込む 押込む
おしこめ	押しこめ 押し籠め 押し込 押し込め 押込 押込め
おしこめる	押しこめる 押し込める 押込める
おしころし	圧し殺し 押し殺し
おしこん	押しこん 押し込ん
おしさげ	おし下げ 押し下げ
おしさげる	押しさげる 押し下げる
おしすすめ	おし進め 押しすすめ 押し進め 推しすすめ 推し進め
おしすすめよう	押し進めよう 推しすすめよう 推し進めよう
おしすすめる	おし進める 押し進める 推し進める
おしたおし	押したおし 押し倒し
おしたて	おし立て 押したて 押し立て 推し立て
おしたてよう	押し立てよう 推し立てよう
おしたてる	押したてる 押し立てる
おしださ	押しださ 押し出さ 押出さ
おしだし	おし出し 押しだし 押し出し 押出し
おしだす	押しだす 押し出す 押出す
おしだせ	おし出せ 押し出せ
おしだまっ	おし黙っ 押し黙っ
おしつけ	押しつけ 押し付け 押付け
おしつけよう	押しつけよう 押し付けよう 押付けよう
おしつける	押しつける 押し付ける 押付ける
おしつけれ	押しつけれ 押し付けれ
おしつぶさ	圧しつぶさ 圧し潰さ 押しつぶさ 押し潰さ
おしつぶし	圧し潰し 押しつぶし 押し潰し
おしつぶす	圧し潰す 押しつぶす 押し潰す
おしつぶせ	押しつぶせ 押し潰せ
おしつぶせる	押しつぶせる 押し潰せる
おしつぶそう	押しつぶそう 押し潰そう
おしつまっ	押しつまっ 押し詰まっ
おしつめ	押しつめ 押し詰め 推し詰め
おしとおし	おし通し 押し通し
おしとおす	おし通す 押し通す
おしとどめ	押しとどめ 押し留め
おしとどめよう	押しとどめよう 押し留めよう
おしとどめる	押しとどめる 押し止どめる 押し留める
おしとめ	押しとめ 押し止め
おしながさ	押し流さ 押流さ
おしながし	押し流し 押流し
おしのけ	押しのけ 押し退け 押し除け
おしのける	押しのける 押し退ける
おしはかっ	推しはかっ 推し測っ 推し量っ
おしはから	推し測ら 推し量ら
おしはかり	推し計り 推し量り
おしはかる	推しはかる 推し測る 推し量る
おしはかれ	推し測れ 推し量れ
おしはかれる	推し測れる 推し量れる
おしひろげ	押しひろげ 押し広げ 押し拡げ
おしひろげよう	おし拡げよう 押し広げよう
おしひろげる	押しひろげる 押し広げる 押し拡げる
おしひろめ	押し広め 推し広め
おしひろめる	押し広める 推し広める
おしま	惜しま 惜ま
おしみ	惜しみ 惜み
おしむ	惜しむ 惜む
おしもどさ	押しもどさ 押し戻さ
おしもどし	押しもどし 押し戻し
おしもどす	押しもどす 押し戻す
おしやっ	押しやっ 押し遣っ
おしよせ	おし寄せ 押しよせ 押し寄せ 押寄せ
おしよせる	押しよせる 押し寄せる 押寄せる
おしわたり	押し渉り 押し渡り
おしん	惜しん 惜ん
おす	圧す 押す 捺す 推す
おせ	押せ 捺せ 推せ
おせる	押せる 推せる
おそいかかっ	襲いかかっ 襲い掛かっ
おそいかから	襲いかから 襲い掛から
おそいかかり	襲いかかり 襲い掛かり
おそいかかる	襲いかかる 襲い掛かる
おそいかかれ	襲いかかれ 襲い掛かれ
おそいかかろう	襲いかかろう 襲い掛かろう
おそう	押そう 推そう 襲う
おそる	恐 恐る
おそるる	恐る 恐るる 恐るゝ
おそれ	怖れ 恐 恐れ 惧れ 懼れ 畏れ 虞れ
おそれいっ	恐れいっ 恐れ入っ
おそれいら	おそれ入ら 恐れいら 恐れ入ら
おそれいり	恐れいり 恐れ入り 恐入り 畏れいり 畏れ入り
おそれいる	恐れいる 恐れ入る
おそれおののい	恐れおののい 恐れ慄い 恐れ戦い 畏れ戦い
おそれおののか	恐れおののか 恐れ慄か
おそれおののき	恐れおののき 恐れ慄き 恐れ戦き 畏れおののき
おそれおののく	恐れおののく 恐れ慄く 恐れ戦く
おそれはばかっ	恐れはばかっ 恐れ憚っ
おそれはばかる	恐れはばかる 恐れ憚る
おそれよ	怖れよ 恐れよ 畏れよ
おそれよう	恐れよう 懼れよう 畏れよう
おそれる	怖れる 恐れる 惧れる 懼れる 畏れる
おち	堕ち 墜ち 落ち 陥ち
おちあい	落ちあい 落ち合い
おちあう	おち合う 落ち合う 落合う
おちいっ	落ち入っ 陥いっ 陥っ
おちいら	陥いら 陥ら
おちいり	落ち入り 陥いり 陥り
おちいる	落ち入る 陥いる 陥る
おちかかっ	落ちかかっ 落ち掛かっ
おちくぼみ	落ちくぼみ 落ち窪み
おちくぼん	落ちくぼん 落ち窪ん
おちこぼれ	落ちこぼれ 落ち零れ
おちこま	落ちこま 落ち込ま
おちこみ	落ちこみ 落ち込み 落込み
おちこむ	落ちこむ 落ち込む 落込む
おちこん	落ちこん 落ち込ん 落込ん
おちつい	落ちつい 落ち付い 落ち着い 落着い
おちつか	落ちつか 落ち付か 落ち着か 落着か
おちつき	落ちつき 落ち着き 落着き
おちつく	落ちつく 落ち付く 落ち着く 落着く
おちつけ	落ちつけ 落ち着け 落着け
おちつける	落ちつける 落ち着ける 落つける
おちのび	落ちのび 落ち延び
おちのびよう	落ちのびよう 落ち延びよう
おちのびる	落ちのびる 落ち延びる
おちぶれ	落ちぶれ 零落れ
おちゆく	落ちゆく 落ち行く
おちよ	堕ちよ 落ちよ
おちよう	堕ちよう 落ちよう
おちる	オチる 堕ちる 墜ちる 落ちる 陥ちる
おちれ	堕ちれ 落ちれ
おちろ	堕ちろ 落ちろ
おちん	堕ちん 落ちん
おっ	居っ 折っ 織っ 負っ 追っ 逐っ
おっかけ	追っかけ 追っ掛け
おっかける	追っかける 追っ掛ける
おっしゃら	仰ら 仰言ら
おっしゃる	仰る 仰言る
おっつけ	押っつけ 押っ付け 追っ付け
おとさ	堕とさ 墜さ 墜とさ 落さ 落とさ 陥さ 陥とさ
おとし	堕とし 墜し 墜とし 墮し 殞し 落し 落とし 陥し 陥とし
おとしいれ	おとし入れ 落としいれ 落とし入れ 陥いれ 陥れ 陥入れ
おとしいれよう	落としいれよう 陥れよう
おとしいれる	おとし入れる 落し入れる 落とし入れる 陥れる
おとしこま	落としこま 落とし込ま
おとしこみ	落としこみ 落とし込み
おとしこむ	落としこむ 落とし込む
おとしこん	落としこん 落とし込ん
おとしめ	落としめ 貶め
おとす	堕とす 墜す 墜とす 殞す 落す 落とす 陥す 陥とす
おとずれ	訪ずれ 訪れ 音信 音信れ
おとずれる	訪ずれる 訪れる
おとせ	オトせ 堕とせ 墜せ 落せ 落とせ 陥せ 陥とせ
おとせる	落せる 落とせる 陥せる
おとそう	墜とそう 落そう 落とそう 陥とそう
おどけ	戯け 滑稽
おどし	嚇し 威し 縅し 脅し
おどしつけ	脅しつけ 脅し付け
おどしとら	脅しとら 脅し取ら
おどす	嚇す 威す 縅す 脅す
おどっ	踊っ 躍っ
おどら	踊ら 躍ら
おどらさ	踊らさ 躍らさ
おどり	踊り 躍り
おどりあかし	踊りあかし 踊り明かし
おどりあかそう	踊りあかそう 踊り明かそう
おどりあがっ	躍りあがっ 躍り上がっ
おどりあがる	おどり上がる 踊り上がる 躍り上がる
おどりうたい	踊り唄い 踊り歌い
おどりうたう	踊り唄う 踊り歌う
おどりこみ	踊り込み 躍り込み
おどりこん	踊り込ん 躍り込ん
おどりで	おどり出 踊り出 躍りで 躍り出
おどりでる	おどり出る 躍りでる 躍り出る
おどりはね	踊りはね 踊り跳ね
おどる	踊る 躍る
おどれ	踊れ 躍れ
おどろい	驚い 驚ろい
おどろき	愕き 驚き
おどろきあきれ	驚きあきれ 驚き呆れ
おどろきあきれる	驚きあきれる 驚き呆れる
おどろきあわて	驚きあわて 驚き慌て
おどろく	愕く 驚く
おののい	慄い 戦い
おののか	慄か 戦か
おののき	慄き 戦き
おののく	慄く 戦く
おは	負は 追は
おひ	負ひ 追ひ
おび	佩び 帯び
おびえ	怯え 脅え
おびえる	怯える 脅える
おびきださ	おびき出さ 誘き出さ
おびきだし	おびき出し 誘き出し
おびきだす	おびき出す 誘き出す
おびきだせる	おびき出せる 誘き出せる
おびきだそう	おびき出そう 誘き出そう
おびきよせ	おびき寄せ 誘き寄せ
おびきよせよう	おびき寄せよう 誘き寄せよう
おびきよせる	おびき寄せる 誘きよせる 誘き寄せる
おびやかさ	脅かさ 脅やかさ
おびやかし	脅かし 脅やかし
おびやかす	脅かす 脅やかす
おびる	佩びる 帯びる
おふ	負ふ 趁ふ 追ふ 逐ふ
おへ	負へ 追へ
おぼえ	憶え 覚え 覺 覺え
おぼえこま	覚えこま 覚え込ま
おぼえこん	覚えこん 覚え込ん
おぼえる	憶える 覚える 覺える
おぼれしぬ	おぼれ死ぬ 溺れ死ぬ
おぼれしん	おぼれ死ん 溺れ死ん
おぼれる	溺れる 溺レる
おもい	念い 思い 想い 憶い
おもいあがっ	思いあがっ 思い上がっ 思い上っ
おもいあがり	思いあがり 思い上がり
おもいあがる	思い上がる 思い上る
おもいあたっ	思いあたっ 思い当たっ 思い当っ
おもいあたら	思い当たら 思い当ら
おもいあたる	思いあたる 思い当たる 思い当る 思ひ当る
おもいあまっ	思いあまっ 思い余っ
おもいあわせ	思いあわせ 思い合わせ
おもいいたっ	思いいたっ 思い至っ
おもいいたり	思いいたり 思い至り
おもいいたる	思いいたる 思い至る
おもいうかば	思いうかば 思い浮かば
おもいうかび	思いうかび 思い浮かび 思い浮び
おもいうかべ	思いうかべ 思い浮かべ 思い浮べ 想い浮かべ
おもいうかべる	思いうかべる 思い浮かべる 思ひ浮べる 想い浮かべる
おもいうかん	思いうかん 思い浮かん
おもいえがい	思いえがい 思い描い 想い描い
おもいえがき	思いえがき 思い描き 想い描き
おもいえがく	おもい描く 思いえがく 思い描く 想い描く
おもいおこさ	思いおこさ 思い起こさ 思い起さ 想い起こさ 想い起さ
おもいおこし	思いおこし 思い起こし 想い起こし
おもいおこす	思い起こす 思い起す 想いおこす 想い起こす
おもいおこせ	思いおこせ 思い起こせ
おもいおこそう	思い起こそう 思い起そう
おもいかえし	思い返し 想いかえし
おもいがけ	思いがけ 思い掛け
おもいきっ	思いきっ 思い切っ 思ひ切っ
おもいきり	思いきり 思い切り
おもいきる	思い切る 思ひ切る
おもいきれ	思いきれ 思い切れ
おもいこがれ	思いこがれ 思い焦がれ
おもいこま	思いこま 思い込ま
おもいこまさ	思いこまさ 思い込まさ
おもいこみ	思いこみ 思い込み
おもいこむ	思いこむ 思い込む
おもいこん	思いこん 思い込ん
おもいしっ	思い知っ 思ひ知っ
おもいしら	思いしら 思い知ら 思ひ知ら
おもいしらさ	思いしらさ 思い知らさ
おもいしれ	思い知れ 思ひ知れ
おもいたち	思いたち 思い断ち 思い立ち 思ひ立ち
おもいたっ	思いたっ 思い断っ 思い立っ
おもいたつ	思い立つ 思ひ立つ
おもいださ	思いださ 思い出さ 想い出さ
おもいだし	思いだし 思い出し 想い出し
おもいだす	思いだす 思い出す 想い出す 憶い出す
おもいだせ	思いだせ 思い出せ 想い出せ 憶い出せ
おもいだそう	思いだそう 思い出そう
おもいちがえ	思いちがえ 思い違え
おもいつい	思いつい 思い付い
おもいつか	思いつか 思い付か
おもいつき	思いつき 思い付き
おもいつく	思いつく 思い付く
おもいつけ	思いつけ 思い付け
おもいつめ	思いつめ 思い詰め 思ひつめ 思ひ詰め
おもいつめる	思いつめる 思い詰める 想いつめる
おもいとどまっ	思いとどまっ 思い止どまっ 思い止まっ 思い留まっ
おもいとどまら	思いとどまら 思い止まら 思い留まら
おもいとどまり	おもい留まり 思いとどまり 思い留まり
おもいとどまる	思いとどまる 思い止まる 思い留まる
おもいとどめ	思いとどめ 思い留め
おもいとどめる	思いとどめる 思い留める
おもいなおし	思いなおし 思い直し
おもいなおす	思いなおす 思い直す
おもいなやん	思いなやん 思い悩ん 思ひ悩ん
おもいめぐらし	思いめぐらし 思い巡らし
おもいめぐらす	思いめぐらす 思い巡らす
おもいやっ	思いやっ 思い遣っ
おもいやら	思いやら 思い遣ら
おもいやる	思いやる 思い遣る
おもいやれる	思いやれる 思い遣れる
おもいわずらう	思いわずらう 思い煩う
おもいわずらっ	思いわずらっ 思い煩っ
おもう	念う 思う 想う 憶う
おもえ	思 思え 想 想え 憶え
おもえる	思える 想える 想る
おもだっ	主だっ 主立っ 重立っ
おもっ	思っ 想っ 重っ
おもてだっ	表だっ 表立っ
おもは	念は 思は 惟は 想は
おもひ	念ひ 思ひ 想ひ
おもふ	念ふ 思ふ 惟ふ 想ふ 憶ふ
おもへ	念へ 思へ 想へ
おもむい	赴い 趣い 趨い
おもむか	赴か 趣か
おもむき	赴き 趣き 趨き
おもむく	赴く 趣く
おもわ	思わ 想わ
おもんじ	重じ 重んじ
おもんずる	重ずる 重んずる
おもんぜ	重ぜ 重んぜ
およい	泳い 游い
およぎ	泳ぎ 游ぎ
およぎだし	泳ぎだし 泳ぎ出し
およぎだす	泳ぎだす 泳ぎ出す
およぎつい	泳ぎつい 泳ぎ付い 泳ぎ着い
およぎまわっ	泳ぎまわっ 泳ぎ回っ
およぎまわり	泳ぎまわり 泳ぎ回り
およぎまわる	泳ぎまわる 泳ぎ回る 泳ぎ廻る
およぼさ	及さ 及ぼさ
およぼし	及し 及ぼし
およぼしあう	およぼし合う 及ぼしあう
およぼす	及す 及ぼす
およぼせ	及せ 及ぼせ
おら	居ら 折ら 織ら
おり	下り 居り 折り 織り 降り
おりあい	折りあい 折り合い
おりあう	折りあう 折り合う
おりあがっ	織りあがっ 織り上がっ
おりあがり	織りあがり 織り上がり
おりあがる	織りあがる 織り上がる
おりあげ	折りあげ 折り上げ 織りあげ 織り上げ
おりあげる	折り上げる 織りあげる 織り上げる
おりあわ	折り合わ 折合わ
おりかえさ	折り返さ 折返さ
おりかえし	折り返し 折返し
おりかえす	折りかえす 折り返す 折返す
おりかさなっ	おり重なっ 折り重なっ 織り重なっ
おりかさなる	折り重なる 織り重なる
おりこま	折りこま 折り込ま 織りこま 織り込ま 織込ま
おりこみ	折りこみ 折り込み 折込み 織りこみ 織り込み 織込み
おりこむ	折りこむ 折り込む 折込む 織りこむ 織り込む 織込む
おりこめる	折り込める 織り込める
おりこもう	折り込もう 織り込もう
おりこん	折りこん 折り込ん 折込ん 織りこん 織り込ん 織込ん
おりたた	下り立た 降り立た
おりたたま	折りたたま 折り畳ま 折畳ま
おりたたみ	折りたたみ 折り畳み 折畳み
おりたたむ	折りたたむ 折り畳む 折畳む
おりたため	折りたため 折り畳め
おりたためる	折りたためる 折り畳める
おりたたん	折りたたん 折り畳ん 折畳ん
おりたち	おり立ち 下り立ち 降りたち 降り立ち
おりたっ	おり立っ 下り立っ 降りたっ 降り立っ
おりたつ	下り立つ 降りたつ 降り立つ
おりとっ	折りとっ 折り取っ
おりなさ	織りなさ 織り成さ
おりなし	織りなし 織り成し 織成し
おりなす	織りなす 織り成す 織成す
おりまげ	折りまげ 折り曲げ 折曲げ
おりまざっ	織り交ざっ 織り混ざっ
おりまぜ	おり交ぜ おり混ぜ 折り混ぜ 織りまぜ 織り交ぜ 織り混ぜ
おりまぜる	織りまぜる 織り交ぜる 織り混ぜる
おりよう	下りよう 降りよう
おりる	オリる 下りる 降りる
おりれ	下りれ 降りれ
おりれる	下りれる 降りれる
おりろ	下りろ 降りろ
おる	折る 織る
おれ	をれ 折れ 織れ
おれまがっ	折れまがっ 折れ曲がっ 折れ曲っ
おれまがる	折れまがる 折れ曲がる 折れ曲る
おれる	をれる 居れる 折れる 織れる
おろう	折ろう 織ろう
おろさ	下ろさ 卸さ 堕さ 堕ろさ 降ろさ
おろし	下ろし 卸し 堕し 堕ろし 降ろし
おろす	下ろす 卸す 堕す 堕ろす 降ろす
おろせ	下ろせ 卸せ 堕ろせ 降ろせ
おろせる	下ろせる 降ろせる
おろそう	下ろそう 卸そう 堕ろそう 降ろそう
おわ	終わ 負わ 追わ 逐わ
おわさ	負わさ 追わさ
おわせ	負わせ 追わせ
おわっ	了っ 終っ 終わっ 終ッ
おわら	了ら 畢ら 終ら 終わら
おわり	畢り 終り 終わり
おわる	了る 畢る 終る 終わる
おわれ	了れ 終れ 終われ
おわろう	終ろう 終わろう
おわん	了ん 畢ん 終わん 終ん
かい	交い 嗅い 掻い 搔い 書い 欠い 画い 買い 賈い 購い 飼い
かいあおり	買いあおり 買い煽り
かいあげ	買い上げ 買上げ
かいあげる	買い上げる 買上げる
かいあさっ	買いあさっ 買い漁っ
かいあさり	買いあさり 買い漁り
かいあさる	買いあさる 買い漁る
かいあたえ	買いあたえ 買い与え
かいあつめ	買いあつめ 買い集め
かいいれ	買いいれ 買い入れ 買入れ
かいいれる	買いいれる 買い入れる 買入れる
かいうけ	買い受け 買い請け 買受け
かいうける	買い受ける 買受ける
かいかえ	買い換え 買い替え 買換え
かいかえる	買い換える 買い替える
かいかぶっ	買いかぶっ 買い被っ
かいかぶり	買いかぶり 買い被り
かいくぐっ	かい潜っ 掻い潜っ 搔い潜っ
かいくぐり	かい潜り 掻いくぐり 掻い潜り 搔い潜り
かいくぐる	かい潜る 掻い潜る
かいこま	買い込ま 買込ま
かいこみ	買いこみ 買い込み
かいこん	買いこん 買い込ん
かいさ	介さ 会さ 解さ
かいし	介し 会し 解し
かいしめ	買い占め 買占め
かいしめよう	買い占めよう 買占めよう
かいしめる	買い占める 買占める
かいす	介す 会す 解す
かいする	介する 会する 解する
かいせ	介せ 会せ
かいそろえ	買いそろえ 買い揃え
かいそろえる	買いそろえる 買い揃える
かいたさ	買いたさ 買い足さ
かいたし	買いたし 買い足し
かいたたい	買いたたい 買い叩い
かいたたか	買いたたか 買い叩か
かいたたき	買いたたき 買い叩き
かいたたく	買いたたく 買い叩く
かいたたけ	買いたたけ 買い叩け
かいため	買いため 買い溜め 買い貯め
かいだし	かい出し 買い出し
かいつけ	買いつけ 買い付け
かいつける	買いつける 買い付ける
かいとっ	買いとっ 買い取っ 買取っ
かいとら	買いとら 買い取ら 買取ら
かいとり	買いとり 買い取り 買取り
かいとる	買いとる 買い取る 買取る
かいならさ	飼いならさ 飼い慣らさ 飼い馴らさ
かいならし	飼いならし 飼い慣らし 飼い馴らし
かいならす	飼いならす 飼い慣らす 飼い馴らす
かいならせ	飼いならせ 飼い慣らせ
かいならそう	飼いならそう 飼い慣らそう
かいまみ	かいま見 垣間み 垣間見
かいまみる	かいま見る 垣間みる 垣間見る
かいもとめ	買いもとめ 買い求め
かいもどさ	買いもどさ 買い戻さ 買戻さ
かいもどし	買いもどし 買い戻し 買戻し
かいもどす	買いもどす 買い戻す 買戻す
かう	交う 支う 買う 購う 飼う
かえ	交え 代え 変え 帰 換え 易え 易へ 替え 買え 飼え
かえさ	反さ 孵さ 帰さ 返さ 還さ
かえし	孵し 帰し 返えし 返し 還し
かえす	反す 孵す 帰す 返す 還す
かえせ	帰せ 返せ 還せ
かえせる	帰せる 返せる
かえせん	帰せん 還せん
かえそう	孵そう 帰そう 返えそう 返そう 還そう
かえっ	却ッ 孵っ 帰っ 帰へっ 返っ 還っ
かえよ	変えよ 買えよ
かえよう	代えよう 変えよう 換えよう 替えよう 買えよう
かえら	孵ら 帰えら 帰ら 歸ら 返へら 返ら 還ら
かえり	孵り 帰えり 帰り 歸り 返り 還り
かえりつい	帰りつい 帰り付い 帰り着い
かえりつき	帰りつき 帰り着き
かえりつく	帰りつく 帰り着く
かえりつけ	帰りつけ 帰り着け
かえりみ	省み 省りみ 返り見 顧 顧み 顧りみ
かえりみよう	省みよう 返り見よう 顧みよう
かえりみる	省みる 顧みる 顧る 顧ル
かえりみれ	省みれ 顧みれ 顧りみれ
かえる	代える 変える 孵る 帰える 帰へる 帰る 換える 易える 替える 買える 返る 還る 飼える
かえれ	代えれ 変えれ 帰れ 換えれ 替えれ 歸れ 返れ 還れ
かえれる	変えれる 帰れる 還れる
かえろ	代えろ 変えろ 帰ろ 替えろ
かえろう	帰ろう 返ろう 還ろう
かえん	代えん 変えん 帰ん 換えん 易へん
かおう	買おう 飼おう
かおら	薫ら 香ら
かおり	薫り 香り 馨り
かおる	薫る 香る 馨る
かか	掻か 書か 欠か 画か
かかえこま	抱えこま 抱え込ま
かかえこみ	かかえ込み 抱えこみ 抱え込み
かかえこむ	かかえ込む 抱えこむ 抱え込む
かかえこん	かかえ込ん 抱えこん 抱え込ん
かかさ	掻かさ 書かさ 欠かさ
かかし	書かし 欠かし
かかす	書かす 欠かす
かかせ	書かせ 欠かせ
かかっ	かゝっ カカっ 係っ 懸かっ 懸っ 懸ッ 掛かっ 掛っ 架かっ 架っ 繋っ 罹かっ 罹っ
かから	かゝら カカら 係ら 懸から 懸ら 掛から 掛ら 架から 架ら 繋ら 罹ら
かかり	かゝり カカり 係り 懸かり 懸り 掛かり 掛り 架かり 架り 繋り 罹かり 罹り
かかる	かゝる カカる 係る 懸かる 懸る 掛かる 掛る 架かる 架る 繋る 罹る
かかれ	カカれ 懸かれ 掛かれ 掛れ 罹れ
かかれる	かゝれる 掛かれる 掛れる
かかわっ	係わっ 拘っ 拘わっ 関っ 関わっ
かかわら	係わら 抱ら 拘ら 拘わら 関ら 関わら
かかわり	係わり 拘り 拘わり 関り 関わり
かかわりあい	かかわり合い 関わりあい 関わり合い
かかわりあう	かかわり合う 係わりあう 関わりあう 関わり合う
かかわりあっ	かかわり合っ 関わりあっ 関わり合っ
かかわりあわ	かかわり合わ 関わり合わ
かかわる	係わる 抱る 拘る 拘わる 関る 関わる
かかわれ	抱れ 拘れ 関れ 関われ
かかわれる	係われる 関われる
かかわろう	係わろう 拘ろう 関ろう 関わろう
かがみこむ	かがみ込む 屈みこむ 屈み込む
かがみこん	かがみ込ん 屈みこん 屈み込ん
かがやい	耀い 輝い
かがやか	耀か 輝か
かがやき	耀き 輝き
かがやく	耀く 赫く 輝く 輝やく
かがやけ	耀け 輝け
かき	掻き 搔き 書き 欠き 画き 缺き
かきあがっ	書きあがっ 書き上がっ
かきあがり	書きあがり 書き上がり
かきあがる	書きあがる 書き上がる
かきあげ	かき上げ かき揚げ 掻き上げ 掻き揚げ 書きあげ 書き上 書き上げ 書上げ
かきあげる	かき上げる 掻き上げる 掻き揚げる 書きあげる 書き上げる 書上げる
かきあつめ	かき集め 掻き集め 搔き集め 書きあつめ 書き集め
かきあつめよう	かき集めよう 掻き集めよう
かきあつめる	かき集める 掻き集める 搔き集める 書き集める
かきあらわさ	描き表さ 書き著さ 書き表さ 書き表わさ
かきあらわし	描き表し 書きあらわし 書き現し 書き著し 書き表し 書き表わし
かきあらわす	描き表す 書きあらわす 書き現わす 書き著す 書き表す 書き表わす
かきあらわせ	描き表せ 書きあらわせ 書き表せ
かきあらわせる	書き表せる 書き表わせる
かきあらわそう	書き現そう 書き表そう
かきいれ	かき入れ 掻き入れ 書き入れ 書入れ
かきいれる	かき入れる 掻き入れる 書き入れる
かきうつさ	書きうつさ 書き写さ 書き移さ
かきうつし	書きうつし 書き写し 書き移し 書写し
かきうつす	書きうつす 書き写す 書き移す
かきおくっ	書きおくっ 書き贈っ 書き送っ
かきおくら	書き贈ら 書き送ら
かきおくり	書き贈り 書き送り
かきおこさ	書きおこさ 書き起こさ
かきおこし	かき起こし 掻き起こし 書きおこし 書き起こし 書き起し
かきおこす	掻き起こす 書きおこす 書き起こす
かきおとさ	かき落とさ 掻き落とさ
かきおとし	かき落とし 掻き落とし 書き落とし
かきおとす	かき落とす 掻き落とす 書き落とす
かきおろさ	書きおろさ 書き下ろさ 書下ろさ
かきおろし	書きおろし 書き下ろし 書下ろし
かきおろす	書きおろす 書き下ろす
かきかえ	書きかえ 書き換え 書き替え 書換え
かきかえる	書きかえる 書き換える 書き替える 書換える
かきかえろ	書きかえろ 書き換えろ
かきかわり	書き変わり 書き換わり
かきかわる	書き変わる 書き換わる
かききえ	かき消え 掻き消え
かききえる	かき消える 掻き消える
かききっ	かき切っ 掻き切っ 搔き切っ
かききら	かき切ら 掻き切ら
かききり	かき切り 掻き切り
かききる	かき切る 掻き切る 搔き切る
かききろう	かき切ろう 掻き切ろう
かきくずし	掻き崩し 書き崩し
かきくだし	書き下し 書下し
かきくだす	書きくだす 書き下す 書下す
かきくどい	かき口説い 掻き口説い
かきくどく	かき口説く 掻き口説く
かきくもっ	かき曇っ 掻き曇っ
かきくもり	かき曇り 掻き曇り
かきくわえ	書きくわえ 書き加え
かきくわえる	書きくわえる 書き加える
かきけさ	かき消さ 掻き消さ
かきけし	かき消し 掻き消し
かきけす	かき消す 掻き消す 掻消す
かきこま	掻き込ま 描き込ま 書きこま 書き込ま 書込ま
かきこみ	かき込み 掻き込み 描き込み 書きこみ 書き込み 書込み
かきこむ	かき込む 掻きこむ 掻き込む 描き込む 書きこむ 書き込む 書込む
かきこめ	描き込め 書きこめ 書き込め
かきこめる	書きこめる 書き込める
かきこもう	書きこもう 書き込もう
かきこん	かき込ん 掻きこん 掻き込ん 描き込ん 書きこん 書き込ん
かきしるさ	書きしるさ 書き記さ 書き誌さ
かきしるし	書きしるし 書き記し 書き誌し
かきしるす	書きしるす 書き記す
かきすすめ	書きすすめ 書き進め
かきすて	かき捨て 書き捨て
かきそえ	書きそえ 書き添え
かきたさ	書きたさ 書き足さ
かきたて	かき立て 掻きたて 掻き立て 搔き立て 書きたて 書き立て
かきたてよう	かき立てよう 掻き立てよう
かきたてる	かき立てる 掻きたてる 掻き立てる 書きたてる 書き立てる
かきため	書きため 書き溜め 書き貯め
かきためる	書きためる 書き溜める 書き貯める
かきたり	書きたり 書き足り
かきださ	かき出さ 掻き出さ 書き出さ
かきだし	かき出し 掻き出し 搔き出し 書きだし 書き出し
かきだす	かき出す 掻き出す 搔き出す 書きだす 書き出す
かきつい	書きつい 書き継い
かきつが	書きつが 書き継が
かきつぎ	書きつぎ 書き継ぎ
かきつぐ	書きつぐ 書き継ぐ
かきつけ	書きつけ 書き付け 書付 書付け
かきつける	書きつける 書き付ける
かきつづっ	書きつづっ 書き綴っ
かきつづら	書きつづら 書き綴ら
かきつづり	書きつづり 書き綴り
かきつづる	書きつづる 書き綴る
かきつらね	書きつらね 書き連ね
かきつらねる	書きつらねる 書き連ねる
かきとっ	かき取っ 掻き取っ 書きとっ 書き取っ 欠き取っ
かきとどめ	書きとどめ 書き留め
かきとどめる	書きとどめる 書き留める
かきとばし	書きとばし 書き飛ばし
かきとめ	書きとめ 書き止め 書き留め 書留め
かきとめる	書きとめる 書き止める 書き留める
かきとら	掻き取ら 書きとら 書き取ら 欠き取ら
かきとり	かき取り 掻き取り 搔き取り 書きとり 書き取り 欠き取り
かきとる	かき取る 掻き取る 搔き取る 書きとる 書き取る
かきなおさ	描き直さ 書き直さ
かきなおし	描き直し 書き直し 書直し
かきなおす	描き直す 書き直す
かきなおせ	書きなおせ 書き直せ
かきなおせる	書きなおせる 書き直せる
かきなおそう	描き直そう 書き直そう
かきなぐっ	書きなぐっ 書き殴っ
かきなぐら	書きなぐら 書き殴ら
かきなぐり	書きなぐり 書き殴り
かきなぐる	書きなぐる 書き殴る
かきならさ	かき鳴らさ 搔き鳴らさ
かきならし	かき鳴らし 掻き慣らし 掻き鳴らし
かきならす	かき鳴らす 掻き鳴らす
かきならべ	書きならべ 書き並べ
かきならべる	書きならべる 書き並べる
かきぬい	書き抜い 書抜い
かきのこさ	書きのこさ 書き残さ 書き遺さ
かきのこし	書きのこし 書き残し 書き遺し 書残し
かきのこす	書き残す 書き遺す 書残す
かきまざり	かき混ざり 掻き混ざり
かきまぜ	かき混ぜ 掻き混ぜ 掻き雑ぜ
かきまぜる	かき混ぜる 掻き混ぜる
かきまとめ	書きまとめ 書き纏め
かきまわさ	かき回さ 掻き回さ
かきまわし	かき回し 掻きまわし 掻き回し
かきまわす	かき回す 掻き回す
かきまわそう	かき回そう 掻き回そう
かきみださ	かき乱さ 掻き乱さ
かきみだし	かき乱し 掻き乱し
かきみだす	かき乱す 掻き乱す 搔き乱す
かきむしっ	掻きむしっ 掻き毟っ
かきむしり	掻きむしり 掻き毟り
かきむしる	掻きむしる 掻き毟る
かきもらし	書きもらし 書き漏らし
かきよせ	かき寄せ 掻き寄せ
かきわけ	かき分け 掻き分け 搔き分け 書き分け
かきわけよう	かき分けよう 掻き分けよう
かきわける	かき分ける 掻き分ける 書き分ける
かぎあてる	嗅ぎあてる 嗅ぎ当てる
かぎだし	かぎ出し 嗅ぎ出し
かぎつけ	かぎ付け 嗅ぎつけ 嗅ぎ付け 嗅付け
かぎつける	嗅ぎつける 嗅ぎ付ける
かぎとっ	かぎ取っ 嗅ぎとっ 嗅ぎ取っ
かぎとり	かぎ取り 嗅ぎとり 嗅ぎ取り
かぎまわっ	かぎ回っ 嗅ぎ回っ
かぎまわり	かぎ回り 嗅ぎ回り
かぎわけ	かぎ分け 嗅ぎわけ 嗅ぎ分け
かぎわける	かぎ分ける 嗅ぎわける 嗅ぎ分ける
かく	掻く 搔く 書く 欠く 画く 缺く
かくさ	匿さ 画さ 隠さ
かくし	劃し 匿し 画し 隠し
かくしもっ	かくし持っ 隠しもっ 隠し持っ
かくす	劃す 画す 隠す
かくせ	劃せ 画せ 隠せ
かくそう	画そう 隠そう
かくばり	角ばり 角張り
かくばる	角ばる 角張る
かくれ	匿れ 薨 隠れ 隱れ
かくれすみ	隠れ住み 隠れ棲み
かくれすむ	隠れ住む 隠れ棲む
かくれすん	隠れ住ん 隠れ棲ん
かくれひそみ	隠れひそみ 隠れ潜み
かくれひそむ	隠れひそむ 隠れ潜む
かくれひそん	隠れひそん 隠れ潜ん
かけ	懸け 掛 掛け 掛ケ 掻け 書け 架け 欠け 缺け 翔け 賭け 闕け 駆け 駈け
かけあい	かけ合い 掛けあい 掛け合い
かけあう	かけ合う 掛けあう 掛け合う
かけあおう	かけ合おう 掛け合おう
かけあがっ	かけ上がっ 駆けあがっ 駆け上がっ 駈け上がっ
かけあがり	かけ上がり 駆けあがり 駆け上がり 駈けあがり 駈け上がり
かけあがる	かけ上がる 駆けあがる 駆け上がる 駈け上がる
かけあがれ	かけ上がれ 駆けあがれ 駆け上がれ
かけあがろう	翔け上がろう 駆けあがろう 駆け上がろう
かけあっ	かけ合っ 掛けあっ 掛け合っ 掛合っ
かけあわ	かけ合わ 掛けあわ 掛け合わ
かけあわさっ	かけ合わさっ 掛け合わさっ
かけあわせ	かけ合せ かけ合わせ 掛け合せ 掛け合わせ 掛合せ
かけあわせる	かけ合わせる 掛け合せる 掛け合わせる
かけあわせれ	掛け合せれ 掛け合わせれ
かけいれ	かけ入れ 駆け入れ
かけおり	かけ下り かけ降り 駆けおり 駆け下り 駆け降り 駈け下り
かけおりよ	駆け下りよ 駆け降りよ
かけおりる	駆け下りる 駆け降りる
かけかえ	かけ替え 掛け換え 掛け替え 架けかえ 架け替え
かけかえる	かけ替える 掛け替える 架け替える
かけくだり	駆け下り 駆け降り
かけこま	駆け込ま 駆込ま
かけこみ	かけ込み 掛け込み 駆けこみ 駆け込み 駆込み 駈けこみ 駈け込み 駈込み
かけこむ	かけ込む 駆けこむ 駆け込む 駆込む 駈け込む
かけこん	駆けこん 駆け込ん 駆込ん 駈け込ん
かけさっ	かけ去っ 駆け去っ 駈け去っ
かけずり	駆けずり 駈けずり
かけださ	かけ出さ 駆け出さ 駆出さ
かけだし	かけ出し 駆けだし 駆け出し 駆出し
かけだす	かけ出す 駆けだす 駆け出す
かけだそう	駆けだそう 駆け出そう
かけちがえ	かけ違え 掛け違え
かけつけ	馳けつけ 駆けつけ 駆け付け 駆け着け 駆付け 駈けつけ
かけつけよう	駆けつけよう 駆け付けよう
かけつける	駆けつける 駆け付ける 駈けつける
かけながさ	かけ流さ 掛け流さ
かけながし	かけ流し 掛け流し
かけながす	かけ流す 掛け流す
かけぬけ	駆けぬけ 駆け抜け 駈け抜け
かけぬける	駆けぬける 駆け抜ける 駈け抜ける
かけのぼっ	かけ上っ かけ登っ 駆け上っ 駆け昇っ 駆け登っ
かけのぼら	駆け上ら 駆け登ら
かけのぼり	駆けのぼり 駆け上り 駆け昇り 駆け登り
かけのぼる	駆けのぼる 駆け上る 駆け昇る 駆け登る 駈け登る
かけのぼれ	駆け上れ 駆け登れ
かけはなれ	かけ離れ 懸け離れ 掛け離れ
かけはなれる	かけ離れる 掛け離れる
かけまわっ	かけ回っ 駆けまわっ 駆け回っ
かけまわら	駆けまわら 駆け回ら
かけまわり	かけ回り 駆けまわり 駆け回り 駈け回り
かけまわる	駆けまわる 駆け回る 駆け廻る 駈け回る
かけめぐっ	かけ巡っ 駆けめぐっ 駆け巡っ 駆け廻っ
かけめぐら	駆けめぐら 駆け巡ら
かけめぐり	駆けめぐり 駆け巡り 駈け巡り
かけめぐる	かけ巡る 翔けめぐる 駆けめぐる 駆け巡る 駈けめぐる
かけもっ	かけ持っ 掛け持っ
かけもどっ	駆け戻っ 駈け戻っ
かけよ	掛けよ 書けよ 架けよ 欠けよ 翔けよ 駆けよ
かけよう	懸けよう 掛けよう 架けよう 賭けよう
かけよっ	かけ寄っ 書けよっ 駆けよっ 駆け寄っ 駈け寄っ
かけより	かけ寄り 駆けより 駆け寄り 駈け寄り
かけよる	駆けよる 駆け寄る
かけよろう	駆け寄ろう 駆寄ろう
かける	× カケる 懸ける 掛ける 掻ける 書ける 架ける 欠ける 翔ける 翔る 賭ける 駆ける 駈ける
かけれ	カケれ 懸けれ 掛けれ 書けれ 架けれ 欠けれ 賭けれ 駆けれ
かけろ	懸けろ 掛けろ 架けろ 翔けろ 賭けろ 駆けろ 駈けろ
かけわたさ	掛け渡さ 架け渡さ
かけわたし	かけ渡し 掛け渡し 架け渡し
かけわたす	掛け渡す 架け渡す
かけん	懸けん 書けん
かげっ	翳っ 陰っ
かげり	翳り 陰り
かげる	嗅げる 翳る 陰る
かこう	囲う 掻こう 搔こう 書こう
かこっ	囲っ 託っ
かさ	仮さ 化さ 架さ 科さ 課さ 貸さ
かさなりあい	重なりあい 重なり合い
かさなりあう	重なりあう 重なり合う
かさなりあっ	重なりあっ 重なり合っ
かさなりあわ	重なりあわ 重なり合わ
かさね	累ね 重ね
かさねあわさ	重ねあわさ 重ね合わさ
かさねあわし	重ねあわし 重ね合わし
かさねあわす	重ねあわす 重ね合わす
かさねあわせ	重ねあわせ 重ね併せ 重ね合せ 重ね合わせ
かさねあわせよう	重ねあわせよう 重ね合わせよう
かさねあわせる	重ねあわせる 重ね合せる 重ね合わせる
かさばら	かさ張ら 嵩張ら
かさばり	かさ張り 嵩ばり 嵩張り
かさばる	かさ張る 嵩張る
かざりたて	飾りたて 飾り立て
かざりたてる	飾りたてる 飾り立てる
かざりつけ	飾りつけ 飾り付け 飾付け
かざりつける	飾りつける 飾り付ける
かし	仮し 借し 化し 呵し 嫁し 架し 科し 課し 貸し
かしあう	貸しあう 貸し合う
かしい	傾い 炊い
かしきっ	貸しきっ 貸し切っ
かしきり	貸しきり 貸し切り
かしきる	貸しきる 貸し切る
かしぐ	傾ぐ 炊ぐ
かしこまっ	畏っ 畏まっ
かしこまる	畏まる 畏る
かしずけ	侍け 傅け
かしださ	貸し出さ 貸出さ
かしだし	貸し出し 貸出し
かしだす	貸し出す 貸出す
かしだせ	貸し出せ 貸出せ
かしつけ	貸しつけ 貸し付け 貸付 貸付け
かしつける	貸しつける 貸し付ける 貸付ける
かしよう	化しよう 課しよう
かじっ	囓っ 齧っ
かじら	囓ら 齧ら
かじり	囓り 齧り
かじりつい	かじり付い 噛り付い
かじりつき	かじり付き 噛り付き
かじりつく	噛り付く 齧り付く
かじる	囓る 齧る
かす	仮す 借す 化す 架す 科す 課す 貸す
かすめ	掠め 霞め
かすめさっ	かすめ去っ 掠め去っ
かすめさり	かすめ去り 掠め去り
かすめさる	かすめ去る 掠め去る
かすめとっ	かすめ取っ 掠め取っ
かすめとら	かすめ取ら 掠め取ら
かすめとり	かすめ取り 掠め取り
かすめとる	かすめ取る 掠め取る
かすめとろう	かすめ取ろう 掠め取ろう
かする	化する 嫁する 掠る 架する 科する 課する
かすれ	掠れ 架すれ
かせ	化せ 嫁せ 架せ 科せ 課せ 貸せ
かそう	仮そう 借そう 化そう 科そう 課そう 貸そう
かぞえ	数え 數へ 算え
かぞえあげ	数えあげ 数え上げ
かぞえあげる	数えあげる 数え上げる 数え挙げる
かぞえあげれ	数えあげれ 数え上げれ 数え挙げれ
かぞえたて	数えたて 数え立て
かぞえる	数える 算える
かた	克た 勝た
かたし	勝たし 片し
かたす	勝たす 片す
かたちづくっ	形づくっ 形作っ 形造っ
かたちづくら	形づくら 形作ら 形造ら
かたちづくり	形づくり 形作り 形造り
かたちづくる	形づくる 形作る 形造る
かたちづくろう	形づくろう 形作ろう 形造ろう
かたちどら	形取ら 象ら
かたっ	語っ 騙っ
かたづい	片づい 片付い
かたづか	片づか 片付か
かたづき	片づき 片付き 片附き
かたづく	片づく 片付く
かたづけ	かたずけ 片づけ 片付け
かたづけよう	片づけよう 片付けよう
かたづける	片づける 片付ける
かたづけれ	片づけれ 片付けれ
かたどっ	型どっ 形どっ 象っ
かたどら	形どら 象ら
かたどり	型どり 形どり 象り
かたどる	形どる 象る
かたまら	固まら 固ら
かたむきかけ	傾きかけ 傾き掛け
かため	固め 堅め
かためる	固める 堅める
かたよっ	偏っ 片寄っ
かたよら	偏ら 片寄ら
かたより	偏り 片より 片寄り
かたよる	偏る 片よる 片寄る
かたよれ	偏れ 片寄れ
かたら	語ら 騙ら
かたらい	語らい 談い
かたらっ	語らっ 談っ
かたり	語り 騙り
かたりあい	語りあい 語り合い
かたりあう	語りあう 語り合う
かたりあかす	語りあかす 語り明かす
かたりあっ	語りあっ 語り合っ
かたりおこす	語り起こす 語り起す
かたりかけ	語りかけ 語り掛け
かたりかける	語りかける 語り掛ける
かたりきかせ	語りきかせ 語り聞かせ
かたりつい	語りつい 語り継い
かたりつが	語りつが 語り継が
かたりつぎ	語りつぎ 語り継ぎ
かたりつぐ	語りつぐ 語り継ぐ
かたりつたえ	語り伝え 語り伝へ
かたる	語る 騙る
かたろう	語ろう 騙ろう
かち	克ち 勝ち
かちあがっ	勝ちあがっ 勝ち上がっ
かちあがり	勝ちあがり 勝ち上がり
かちあがる	勝ちあがる 勝ち上がる
かちあがれ	勝ちあがれ 勝ち上がれ
かちえ	かち得 勝ち得 贏ち得
かちえる	かち得る 勝ち得る
かちこし	勝ち越し 勝越し
かちとっ	かち取っ 勝ちとっ 勝ち取っ
かちとら	勝ちとら 勝ち取ら
かちとり	かち取り 勝ちとり 勝ち取り
かちとる	かち取る 勝ちとる 勝ち取る
かちとろう	かち取ろう 勝ちとろう 勝ち取ろう
かちほこる	勝ちほこる 勝ち誇る
かっ	かッ 交っ 借っ 克っ 刈っ 勝っ 狩っ 穫っ 買っ 飼っ 駆っ 駈っ
かっとばす	かっ飛ばす カッ飛ばす
かっとび	かっ飛び カッ飛び
かつ	克つ 剋つ 勝つ
かつい	担い 舁い
かつぎ	担ぎ 舁ぎ
かつぎあげ	かつぎ上げ 担ぎあげ 担ぎ上げ
かつぎあげる	担ぎあげる 担ぎ上げる
かつぎこま	かつぎ込ま 担ぎこま 担ぎ込ま
かつぎこみ	かつぎ込み 担ぎ込み
かつぎこん	担ぎこん 担ぎ込ん
かつぎださ	かつぎ出さ 担ぎ出さ
かつぎだし	かつぎ出し 担ぎ出し
かつぎだす	かつぎ出す 担ぎ出す
かて	克て 勝て 捷て
かと	克と 勝と
かどわかさ	拐かさ 拐さ
かどわかし	拐かし 拐し
かない	叶い 敵い 適い
かなう	叶う 敵う 称う 適う
かなえ	叶え 適え
かなえる	叶える 適える
かなしま	哀しま 悲しま 悲ま
かなしみ	哀しみ 悲しみ 悲み
かなしみなげい	哀しみ嘆い 悲しみ嘆い
かなしむ	哀しむ 悲しむ 悲む
かなしん	哀しん 悲しん 悲ん
かなっ	叶っ 適っ
かなわ	叶わ 敵わ 適わ
かねあわせ	兼ねあわせ 兼ね併せ 兼ね合わせ
かねあわせる	兼ね併せる 兼ね合わせる
かねそなえ	かね備え 兼ねそなえ 兼ね備え 兼ね具え
かねそなえる	兼ねそなえる 兼ね備える
かのふ	叶ふ 称ふ 適ふ
かばいあい	かばい合い 庇い合い
かばいあう	かばい合う 庇い合う
かばいあっ	かばい合っ 庇い合っ
かぶせ	冠せ 被せ
かぶせる	冠せる 被せる
かぶっ	カブっ 冠っ 被っ
かぶら	カブら 冠ら 被ら
かぶり	カブり 冠り 被り
かぶりつく	かぶり付く 齧り付く
かぶりなおし	かぶり直し 被り直し
かぶりなおす	かぶり直す 被り直す
かぶる	カブる 冠る 被る
かぶれ	カブれ 冠れ 気触れ 被れ
かへ	変へ 替へ 買へ
かま	咬ま 噛ま 嚙ま 構
かまさ	咬まさ 噛まさ
かみ	咬み 噛み 嚙み 擤み
かみあい	かみ合い 噛みあい 噛み合い 噛合い
かみあう	かみ合う 噛みあう 噛み合う 噛合う 嚙み合う
かみあえ	かみ合え 噛み合え
かみあっ	かみ合っ 噛みあっ 噛み合っ 噛合っ
かみあわ	かみ合わ 噛みあわ 噛み合わ 噛合わ 嚙み合わ
かみあわさっ	かみ合わさっ 噛み合わさっ
かみあわせ	かみ合わせ 噛み合せ 噛み合わせ 噛合わせ
かみあわせる	かみ合わせる 噛み合せる 噛み合わせる 噛合わせる
かみきっ	かみ切っ 噛み切っ 嚙み切っ
かみきら	かみ切ら 噛み切ら 嚙み切ら
かみきり	かみ切り 噛み切り 嚙み切り
かみきる	かみ切る 噛み切る 嚙み切る
かみきれ	かみ切れ 噛み切れ
かみくだい	かみ砕い 噛みくだい 噛み砕い
かみくだか	かみ砕か 噛み砕か 嚙み砕か
かみくだき	かみ砕き 噛み砕き
かみくだく	かみ砕く 噛み砕く
かみころさ	かみ殺さ 咬み殺さ 噛み殺さ
かみころし	かみ殺し 咬み殺し 噛み殺し
かみころす	かみ殺す 咬み殺す 噛み殺す 嚙み殺す
かみしめ	かみ締め 噛みしめ 噛み締め 嚙みしめ 嚙み締め
かみしめる	かみ締める 噛みしめる 噛み締める
かみちぎっ	咬みちぎっ 噛みちぎっ
かみちぎる	噛みちぎる 嚙みちぎる
かみつい	咬みつい 噛みつい 噛み付い 噛付い 嚙みつい 嚙み付い
かみつか	咬みつか 噛みつか 噛み付か 嚙みつか
かみつき	かみ付き 咬みつき 噛みつき 噛み付き 噛付き 嚙みつき
かみつく	かみ付く 咬みつく 噛みつく 噛み付く 嚙みつく 嚙み付く
かみつこう	噛みつこう 噛み付こう
かみつぶし	噛みつぶし 噛み潰し 嚙み潰し
かみわける	かみ分ける 噛み分ける
かむ	咬む 噛む 噬む 嚙む 嚼む 擤む
かめ	咬め 噛め
かもう	咬もう 噛もう
かもしださ	かもし出さ 醸しださ 醸し出さ
かもしだし	かもし出し 醸しだし 醸し出し
かもしだす	かもし出す 醸しだす 醸し出す
かもす	醸す 釀す
かよいあう	通いあう 通い合う
かよいあっ	通いあっ 通い合っ
かよいつめ	通いつめ 通い詰め
かよいつめる	通いつめる 通い詰める
から	借ら 刈ら 狩ら 駆ら 駈ら
からし	嗄らし 枯らし 涸らし
からす	嗄らす 枯らす
からみ	搦み 絡み
からみあい	からみ合い 搦み合い 絡みあい 絡み合い
からみあう	からみ合う 絡みあう 絡み合う
からみあっ	からみ合っ 絡みあっ 絡み合っ
からみあわせ	からみ合わせ 絡み合わせ
からみあわせる	からみ合わせる 絡み合わせる
からみつい	絡みつい 絡み付い
からみつか	絡みつか 絡み付か
からみつき	絡みつき 絡み付き
からみつく	絡みつく 絡み付く
からめ	搦め 絡め
からめあう	絡めあう 絡め合う
からめとっ	からめ取っ 搦めとっ 絡めとっ 絡め取っ
からめとら	搦め取ら 搦め捕ら 絡めとら 絡め取ら
からめとり	からめ捕り 搦め捕り 絡めとり 絡め取り
からめとる	からめ取る 絡めとる 絡め取る
からめとろう	絡めとろう 絡め取ろう
かり	借り 刈り 狩り 穫り 苅り 藉り 駆り 駈り
かりあげ	借り上げ 刈りあげ 刈り上げ
かりあげる	借り上げる 刈りあげる 刈り上げる
かりあつめ	かり集め 借り集め 刈り集め 狩り集め 駆り集め
かりあつめる	かり集める 狩り集める
かりいれ	借りいれ 借り入れ 借入れ 刈り入れ 刈入れ
かりいれる	借り入れる 借入れる 刈り入れる 刈入れる
かりうけ	借りうけ 借り受け 借受け
かりうける	借りうける 借り受ける 借受ける
かりかえ	借りかえ 借り換え 借り替え
かりかえよう	借り換えよう 借り替えよう
かりかえる	借り換える 借り替える 借換える
かりこん	刈り込ん 刈込ん
かりそろえる	刈りそろえる 刈り揃える
かりたて	かり立て 狩りたて 狩り立て 駆りたて 駆り立て
かりたてよう	狩りたてよう 駆り立てよう
かりたてる	狩りたてる 狩り立てる 駆りたてる 駆り立てる
かりださ	かり出さ 借り出さ 狩り出さ 駆り出さ 駆出さ
かりだし	かり出し 借り出し 借出し 狩り出し 狩出し 駆り出し
かりだす	かり出す 借り出す 狩り出す 駆り出す
かりだそう	借り出そう 狩り出そう 駆り出そう
かりとっ	刈りとっ 刈り取っ 刈取っ
かりとら	刈りとら 刈り取ら 刈取ら
かりとり	刈りとり 刈り取り 刈取り
かりとる	かり取る 刈りとる 刈り取る 刈取る
かりはらい	刈り払い 刈払い
かりはらう	刈り払う 刈払う
かりる	借りる 藉りる
かる	借る 刈る 狩る 穫る 駆る 駈る
かれ	借れ 刈れ 枯 枯れ 涸れ 渇れ 狩れ 穫れ
かれあがっ	枯れあがっ 枯れ上がっ
かれあがり	枯れ上がり 涸れ上がり
かれあがる	枯れあがる 枯れ上がる
かれる	借れる 枯る 枯れる 涸れる 渇れる 狩れる
かろう	借ろう 刈ろう 狩ろう
かわ	交わ 変わ 買わ 購わ 飼わ
かわい	乾い 渇い
かわか	乾か 干か 渇か
かわかさ	乾かさ 渇かさ
かわかし	乾かし 渇かし
かわき	乾き 干き 渇き 燥き
かわく	乾く 干く 渇く
かわけ	乾け 渇け
かわさ	交さ 交わさ 買わさ 躱さ 飼わさ
かわし	交し 交わし 替わし 躱し
かわしあい	交わしあい 交わし合い
かわしあう	交わしあう 交わし合う
かわしあっ	交わしあっ 交わし合っ
かわす	交す 交わす 躱す
かわせ	交わせ 買わせ 躱せ
かわせる	交せる 交わせる
かわそう	交わそう 替わそう 躱そう
かわっ	代っ 代わっ 変っ 変わっ 換わっ 替っ 替わっ
かわら	代ら 代わら 変ら 変わら 換わら 替ら 替わら
かわり	代り 代わり 変り 変わり 換わり 替り 替わり 變り
かわりゆく	変わりゆく 変わり行く
かわる	代る 代わる 変る 変わる 換わる 替る 替わる 變る
かわれ	代れ 代われ 変れ 変われ 換われ 替われ
かわれる	代れる 代われる 変われる 替われる
かわろ	代ろ 変ろ
かわろう	代ろう 代わろう 変わろう 替わろう
かわん	変わん 替わん
かん	咬ん 噛ん 嚙ん
かんがえ	考 考え
かんがえあわせ	考えあわせ 考え併せ 考え合せ 考え合わせ
かんがえあわせる	考えあわせる 考え併せる 考え合わせる
かんがえあわせれ	考えあわせれ 考え併せれ 考え合わせれ
かんがえおよび	考えおよび 考え及び
かんがえこま	考えこま 考え込ま
かんがえこみ	考えこみ 考え込み
かんがえこむ	考えこむ 考え込む
かんがえこん	考えこん 考え込ん
かんがえださ	考えださ 考え出さ
かんがえだし	考えだし 考え出し
かんがえだす	考えだす 考え出す
かんがえつい	考えつい 考え付い
かんがえつか	考えつか 考え付か
かんがえつき	考えつき 考え付き
かんがえつく	考えつく 考え付く
かんがえなおさ	考えなおさ 考え直さ
かんがえなおし	考えなおし 考え直し
かんがえなおす	考えなおす 考え直す
かんがえなおせ	考えなおせ 考え直せ
かんがえる	考える 考る
かんぐっ	勘ぐっ 勘繰っ
かんぐら	勘ぐら 勘繰ら
かんぐり	勘ぐり 勘繰り
かんぐる	勘ぐる 勘繰る
かんさ	冠さ 関さ
かんし	冠し 姦し 箝し 緘し 関し 關し
かんじ	感じ 観じ
かんじあい	感じあい 感じ合い
かんじあう	感じあう 感じ合う
かんじいっ	感じいっ 感じ入っ
かんじいり	感じいり 感じ入り
かんじいる	感じいる 感じ入る
かんじとっ	感じとっ 感じ取っ
かんじとら	感じとら 感じ取ら
かんじとり	感じとり 感じ取り
かんじとる	感じとる 感じ取る
かんじとれ	感じとれ 感じ取れ
かんじとれる	感じとれる 感じ取れる
かんじる	カンじる 感じる 観じる
かんす	冠す 関す
かんする	冠する 姦する 関する 關する
かんすれ	冠すれ 関すれ
かんずる	感ずる 観ずる
かんせ	冠せ 関せ
かんぜ	感ぜ 観ぜ
かんづい	勘づい 勘付い 感づい 感付い
かんづか	勘づか 勘付か 感づか 感付か
かんづき	勘づき 勘付き 感づき 感付き
かんづく	勘づく 勘付く 感づく 感付く
がいし	害し 慨し 概し
がえんじ	肯じ 肯んじ
がえんじよう	肯じよう 肯んじよう
がえんぜ	肯ぜ 肯んぜ
がし	賀し 駕し
がする	賀する 駕する
がんばっ	ガンバっ 頑張っ
がんばら	ガンバら 頑張ら
がんばれ	ガンバれ 頑張れ
がんばろう	ガンバろう 頑張ろう
き	来 着 著 衣 被
きあわせ	来合せ 来合わせ
きい	利い 効い 尋い 聞い 聴い 訊い
きえうせ	消えうせ 消え失せ
きえうせる	消えうせる 消え失せる
きえうせろ	消えうせろ 消え失せろ
きえさっ	消えさっ 消え去っ
きえさら	消えさら 消え去ら
きえさり	消えさり 消え去り
きえさる	消えさる 消え去る
きえゆき	消えゆき 消え行き
きえゆく	消えゆく 消え行く
きか	利か 効か 聞か 聴か 聽か 訊か
きかさ	利かさ 効かさ 聞かさ 聞さ 聴かさ
きかし	利かし 効かし 聞かし 聞し 聴かし
きかす	利かす 効かす 聞かす 聞す 聴かす
きかせ	利かせ 効かせ 聞せ 聴かせ
きがえ	着がえ 着替え
きき	利き 効き 聞き 聴き 訊き
ききあう	聞きあう 聞き合う
ききあき	聞きあき 聞き飽き 聴き飽き
ききあさる	聞き漁る 聴きあさる
ききあっ	聞きあっ 聞き合っ
ききあわせ	聞き合わせ 聴き合わせ
ききいっ	聞き入っ 聴き入っ
ききいり	聞き入り 聴き入り
ききいる	聞き入る 聴き入る
ききいれ	聞きいれ 聞き入れ 聴きいれ 聴き入れ
ききいれよう	聞きいれよう 聞き入れよう
ききいれる	聞きいれる 聞き入れる 聴き入れる
ききおぼえ	聞きおぼえ 聞き覚え
ききおよび	聞きおよび 聞き及び 聞及び
ききおよん	聞きおよん 聞き及ん
ききかえし	聞き返し 聴き返し 訊き返し
ききかえす	聞き返す 聴き返す 訊き返す
ききくらべ	聞き比べ 聴き比べ
ききくらべる	聞きくらべる 聞き比べる 聴きくらべる 聴き比べる
ききくらべれ	聞き比べれ 聴き比べれ
ききこみ	聞きこみ 聞き込み 聴き込み
ききこむ	聞きこむ 聞き込む 聴き込む
ききこん	聞きこん 聞き込ん 聴き込ん
ききただし	聞きただし 聞き質し
ききただす	聞き質す 訊きただす
ききださ	聞きださ 聞き出さ
ききだし	聞きだし 聞き出し
ききだす	聞きだす 聞き出す
ききだせ	聞きだせ 聞き出せ
ききだせる	聞きだせる 聞き出せる
ききだそう	聞きだそう 聞き出そう
ききちがえ	聞きちがえ 聞き違え
ききつけ	聞きつけ 聞き付け
ききつける	聞きつける 聞き付ける
ききとがめ	聞きとがめ 聞き咎め
ききとっ	聞きとっ 聞き取っ 聴きとっ 聴き取っ
ききとどけ	聞きとどけ 聞き届け 聞届け
ききとら	聞きとら 聞き取ら 聴き取ら 聴取ら
ききとり	聞きとり 聞き取り 聞取り 聴きとり 聴き取り 聴取り
ききとる	聞きとる 聞き取る 聞取る 聴きとる 聴き取る
ききとれ	聞きとれ 聞き取れ 聞取れ 聴きとれ 聴き取れ
ききとれる	聞きとれる 聞き取れる 聴きとれる 聴き取れる
ききとろう	聞き取ろう 聴き取ろう
ききなおし	聞きなおし 聞き直し 訊き直し
ききなおす	聞きなおす 聞き直す
ききながさ	聞き流さ 聴き流さ
ききながし	聞き流し 聴き流し
ききながす	聞き流す 聴き流す
ききなし	聞きなし 聞き做し
ききのがさ	聞き逃さ 聴き逃さ
ききのがし	聞きのがし 聞き逃し 聴き逃し
ききのがす	聞き逃す 聴き逃す
ききほれ	きき惚れ 聞きほれ 聞き惚れ 聴きほれ 聴き惚れ
ききほれる	聞き惚れる 聴きほれる 聴き惚れる
ききもらさ	聞き洩らさ 聞き漏らさ
ききもらす	聞きもらす 聞き漏らす 聴き漏らす
ききわけ	聞きわけ 聞き分け 聴き分け
ききわける	きき分ける 聞きわける 聞き分ける 聴き分ける
きく	利く 効く 聞 聞く 聴く 聽く 訊く
きけ	利け 効け 聞け 聴け 訊け
きけよ	聞けよ 聴けよ
きける	利ける 聞ける 聴ける
きけれ	聞けれ 聴けれ
きこ	聞こ 聴こ
きこう	利こう 聞こう 聴こう 訊こう
きこえ	聞え 聞こえ 聴こえ
きこえる	聞える 聞こえる 聴こえる
きこえれ	聞こえれ 聴こえれ
きこえん	聞えん 聞こえん
きこみ	着こみ 着込み
きこむ	着こむ 着込む
きこん	着こん 着込ん
きざし	兆し 萌し
きざす	兆す 萌す
きざま	刻ま 彫ま
きざみこま	刻みこま 刻み込ま
きざみこみ	刻みこみ 刻み込み
きざみこむ	刻みこむ 刻み込む
きざみこめ	刻みこめ 刻み込め
きざみこん	刻みこん 刻み込ん
きざみつけ	刻みつけ 刻み付け
きざみつける	刻みつける 刻み付ける
きし	帰し 期し 着し
きする	帰する 期する 記する
きすれ	帰すれ 記すれ
きずきあげ	築きあげ 築き上げ
きずきあげよう	築きあげよう 築き上げよう
きずきあげる	築きあげる 築き上げる
きずつい	傷つい 傷付い 疵付い
きずつか	傷つか 傷付か
きずつき	傷つき 傷付き 疵付き
きずつく	傷つく 傷付く
きずつけ	傷つけ 傷付け 疵付け
きずつけよう	傷つけよう 傷付けよう
きずつける	傷つける 傷付ける
きせ	帰せ 期せ 着せ 記せ
きそいあい	競いあい 競い合い
きそいあう	競いあう 競い合う
きそいあっ	競いあっ 競い合っ
きそいあわ	競いあわ 競い合わ
きそう	期そう 競う
きたえあげ	鍛えあげ 鍛え上げ
きたえあげる	鍛えあげる 鍛え上げる
きたさ	来さ 来たさ
きたし	來し 来し 来たし
きたす	來す 来す 来たす
きたせ	來せ 来たせ
きたっ	来たっ 来っ
きたり	来たり 来り
きたる	来たる 来る
きたれ	来たれ 来れ
きっ	キっ 伐っ 切っ 切ッ 剪っ 截っ 斬っ
きづい	気づい 気付い
きづか	気づか 気付か
きづかい	気づかい 気遣い
きづかう	気づかう 気遣う
きづかさ	気づかさ 気付かさ
きづかっ	気づかっ 気遣っ
きづかわ	気づかわ 気遣わ
きづき	気づき 気付き
きづく	気づく 気付く
きづけ	気づけ 気付け
きづける	気づける 気付ける
きづこう	気づこう 気付こう
きどっ	気どっ 気取っ
きどら	気どら 気取ら
きどり	気どり 気取り
きどる	気どる 気取る
きどろう	気どろう 気取ろう
きぶくれ	着ぶくれ 着膨れ
きまっ	キマっ 極っ 極まっ 決っ 決まっ
きまら	キマら 極まら 極ら 決まら 決ら
きまり	キマり 極まり 極り 決まり 決り
きまる	キマる 極まる 極る 決まる 決る
きまれ	極まれ 極れ 決まれ
きまろう	極まろう 決まろう
きまわし	着まわし 着回し
きめ	决め 決め
きめこま	決めこま 決め込ま
きめこみ	きめ込み 決めこみ 決め込み
きめこむ	決めこむ 決め込む
きめこん	決めこん 決め込ん
きめつけ	極付け 決めつけ 決め付け
きめつける	決めつける 決め付ける
きめよう	キメよう 決めよう
きめる	キメる 決める
きゅうし	休し 窮し 給し
きゅうする	休する 窮する 給する
きゅうせ	休せ 窮せ 給せ
きょうさ	供さ 境さ
きょうざめ	興ざめ 興醒め
きょうし	供し 境し 狂し 饗し
きょうしよう	供しよう 饗しよう
きょうする	供する 境する 狂する 饗する
きょうせ	供せ 饗せ
きよめ	浄め 清め 潔め 聖め
きよめる	浄める 清める 潔める
きら	キら 伐ら 切ら 剪ら 斫ら 斬ら 霧ら
きらさ	切らさ 斬らさ
きらめい	煌い 煌めい 燦めい
きらめか	煌か 煌めか
きらめき	煌き 煌めき 燦めき
きらめく	煌く 煌めく 燦めく
きり	キり 伐り 切り 截り 斫り 斬り 鑽り
きりあい	切り合い 斬りあい 斬り合い
きりあう	切り合う 斬りあう 斬り合う
きりあげ	切りあげ 切り上 切り上げ 切上げ 斬り上げ
きりあげる	切りあげる 切り上げる 斬り上げる
きりあっ	切り合っ 斬りあっ 斬り合っ
きりあわ	切り合わ 斬り合わ
きりおとさ	切り落さ 切り落とさ 切落とさ 斬り落さ 斬り落とさ
きりおとし	切りおとし 切り落し 切り落とし 切落し 切落とし 斬り落し 斬り落とし
きりおとす	切りおとす 切り落す 切り落とす 切落とす 斬り落とす
きりおろし	切りおろし 切り下ろし 斬り下ろし
きりおろす	切りおろす 切り下ろす 斬り下ろす
きりかえ	切りかえ 切り変え 切り換え 切り替え 切換え 切替え
きりかえさ	切りかえさ 切り返さ
きりかえし	切りかえし 切り返し 切返し 斬り返し
きりかえす	切り返す 斬り返す
きりかえる	切りかえる 切り変える 切り換える 切り替える 切換える 切替える
きりかえれ	切り替えれ 切替えれ
きりかかっ	切り掛っ 斬りかかっ
きりかかり	切り掛かり 斬りかかり
きりかけ	切り掛け 切り欠け 切掛け
きりかわっ	切りかわっ 切り変わっ 切り換わっ 切り替っ 切り替わっ 切替わっ
きりかわら	切り替ら 切り替わら 切替ら 切替わら
きりかわり	切りかわり 切り変わり 切り換わり 切り替り 切り替わり 切替り 切替わり
きりかわる	切り変わる 切り換わる 切り替る 切り替わる 切替る 切替わる
きりきざま	切りきざま 切り刻ま 斬り刻ま
きりきざみ	切り刻み 斬り刻み
きりきざむ	切りきざむ 切り刻む 斬り刻む
きりきざん	切りきざん 切り刻ん 斬り刻ん
きりくずさ	切りくずさ 切り崩さ 切崩さ 斬り崩さ
きりくずし	切りくずし 切り崩し 切崩し
きりこま	切り込ま 斬り込ま
きりこみ	切りこみ 切り込み 切込み 斬りこみ 斬り込み
きりこむ	切り込む 切込む 斬りこむ 斬り込む
きりこめ	切り込め 斬り込め
きりこもう	切り込もう 斬り込もう
きりころさ	切り殺さ 斬り殺さ
きりころし	切り殺し 斬り殺し
きりころす	切り殺す 斬り殺す
きりころそう	切り殺そう 斬り殺そう
きりこん	切りこん 切り込ん 切込ん 斬りこん 斬り込ん
きりさい	切りさい 切り裂い 斬り裂い
きりさいなま	切りさいなま 斬り苛ま
きりさか	切りさか 切り割か 切り裂か 斬り裂か
きりさき	切り裂き 切裂き 斬り裂き
きりさく	切り裂く 斬り裂く
きりさげ	切り下げ 切下げ 斬り下げ
きりさげる	切り下げる 切下げる
きりすて	切り捨て 切り棄て 切捨て 斬りすて 斬り捨て
きりすてよ	切り捨てよ 斬り捨てよ
きりすてよう	切り捨てよう 斬り捨てよう
きりすてる	切りすてる 切り捨てる 切捨てる 斬り捨てる
きりそろえ	切りそろえ 切り揃え
きりそろえる	切りそろえる 切り揃える
きりたおさ	伐り倒さ 切り倒さ 斬り倒さ
きりたおし	伐り倒し 切り倒し 斬り倒し
きりたおす	伐り倒す 切りたおす 切り倒す 斬り倒す
きりたっ	切りたっ 切り立っ 切立っ
きりたつ	切り立つ 切立つ
きりたて	切り立て 斬り立て
きりださ	きり出さ 切りださ 切り出さ 切出さ
きりだし	切りだし 切り出し 切出し
きりだす	切りだす 切り出す 切出す
きりつけ	切りつけ 切り付け 切付け 斬りつけ 斬り付け
きりつけよう	切りつけよう 斬りつけよう 斬り付けよう
きりつける	切りつける 切り付ける 斬りつける 斬り付ける
きりつめ	切りつめ 切り詰め 切詰め
きりつめる	切りつめる 切り詰める 切詰める
きりとっ	切りとっ 切り取っ 切り採っ 切り撮っ 切取っ 斬り取っ
きりとばさ	切り飛ばさ 斬り飛ばさ
きりとばし	切り飛ばし 斬り飛ばし
きりとばす	切り飛ばす 斬り飛ばす
きりとら	切りとら 切り取ら 切り撮ら 切取ら 斬り取ら
きりとり	切りとり 切り取り 切り撮り 切取り
きりとる	切りとる 切り取る 切り撮る 切取る 斬りとる
きりとれ	切りとれ 切り取れ
きりとろう	切りとろう 切り取ろう
きりぬい	切りぬい 切り抜い
きりぬか	切りぬか 切り抜か
きりぬき	切り抜き 切抜き
きりぬく	切りぬく 切り抜く
きりぬけ	きり抜け 切りぬけ 切り抜け 切抜 切抜け
きりはずし	切りはずし 切り外し
きりはなさ	切りはなさ 切り放さ 切り離さ 切放さ 切離さ
きりはなし	切りはなし 切り放し 切り離し 切放し 切離し
きりはなす	切りはなす 切り放す 切り離す 切離す
きりはなせ	切りはなせ 切り離せ 切離せ
きりはなそう	切り放そう 切り離そう
きりはらい	切りはらい 切り払い 斬り払い
きりはらう	伐り払う 切りはらう 切り払う 斬り払う
きりはらっ	伐り払っ 切りはらっ 切り払っ 切払っ 斬り払っ
きりはらわ	伐りはらわ 伐り払わ 切りはらわ 切り払わ
きりひらい	きり開い 切りひらい 切り拓い 切り開い
きりひらか	きり開か 伐り開か 切りひらか 切り拓か 切り開か
きりひらき	きり拓き 切りひらき 切り拓き 切り開き 切開き
きりひらく	きり拓く 切りひらく 切り拓く 切り開く 切開く 斬り開く
きりひらけ	切り拓け 切り開け
きりひらこう	切りひらこう 切り拓こう 切り開こう
きりふせ	切り伏せ 斬りふせ 斬り伏せ
きりふせる	切り伏せる 斬り伏せる
きりまわさ	切りまわさ 切り回さ
きりまわし	切りまわし 切り回し
きりまわす	切りまわす 切り回す
きりまわせ	切りまわせ 切り回せ 切回せ
きりむすば	切り結ば 切結ば
きりむすび	切り結び 斬り結び
きりむすぶ	切り結ぶ 切結ぶ 斬り結ぶ
きりむすん	切り結ん 斬り結ん
きりもどし	切り戻し 切戻し
きりわけ	切りわけ 切り分 切り分け
きりわける	切りわける 切り分ける
きりわっ	切り割っ 斬り割っ
きる	キる 伐る 切る 剪る 截る 斫る 斬る 着 着る 著る 被る
きれ	キれ 伐れ 切れ 截れ 斬れ 着れ
きれる	キレる 伐れる 切れる 斬れる 着れる
きれろ	キレろ 切れろ
きれん	キれん 切れん
きろう	伐ろう 切ろう 嫌う 斬ろう
きわだた	きわ立た 際だた 際立た
きわだち	際だち 際立ち
きわだっ	きわ立っ 際だっ 際立っ
きわだつ	際だつ 際立つ
きわだて	際だて 際立て
きわまり	極まり 窮まり 谷まり
きわまる	極まる 窮まる
きわめ	極め 究め 窮め
きわめよう	極めよう 究めよう
きわめる	極める 究める 窮める
きわめれ	極めれ 究めれ
きわめん	極めん 究めん 窮めん
ぎさ	擬さ 議さ
ぎし	擬し 艤し 議し
ぎす	擬す 議す
ぎする	擬する 議する
ぎせ	擬せ 議せ
ぎょし	御し 馭し
ぎょする	御する 馭する
くい	喰い 悔い 食い
くいあらさ	喰い荒らさ 食い荒さ 食い荒らさ
くいあらし	くい荒らし 喰い荒らし 食い荒らし
くいあらす	喰い荒らす 食いあらす 食い荒らす
くいあらため	悔い改め 悔改め
くいあらためる	悔いあらためる 悔い改める
くいいっ	喰い入っ 食い入っ
くいいり	くい入り 食い入り
くいこま	くい込ま 喰い込ま 食い込ま
くいこみ	くい込み 喰いこみ 喰い込み 食いこみ 食い込み
くいこむ	くい込む 喰い込む 食いこむ 食い込む 食込む
くいこめ	食いこめ 食い込め
くいこもう	食いこもう 食い込もう
くいころさ	喰い殺さ 食い殺さ
くいころし	喰い殺し 食い殺し
くいころす	喰い殺す 食い殺す
くいころそう	喰い殺そう 食い殺そう
くいこん	くい込ん 喰いこん 喰い込ん 食いこん 食い込ん 食込ん
くいさがっ	喰い下がっ 食いさがっ 食い下がっ
くいさがり	喰い下がり 食い下がり
くいさがる	喰い下がる 食い下がる
くいしばっ	喰いしばっ 食いしばっ 食い縛っ
くいしばれ	食いしばれ 食い縛れ
くいちがい	喰い違い 喰違い 食い違い 食違い
くいちがう	食いちがう 食い違う 食違う
くいちがっ	くい違っ 喰い違っ 食いちがっ 食い違っ 食違っ
くいちぎっ	喰いちぎっ 喰い千切っ 食いちぎっ 食い千切っ
くいちぎら	喰いちぎら 喰い千切ら 食いちぎら 食い千切ら
くいちぎり	喰いちぎり 食いちぎり 食い千切り
くいちぎる	喰いちぎる 食いちぎる 食い千切る
くいつい	喰いつい 喰い付い 食いつい 食い付い
くいつか	喰いつか 喰い付か 食いつか 食い付か
くいつき	喰いつき 喰い付き 食いつき 食い付き
くいつく	喰いつく 喰い付く 食いつく 食い付く
くいつこう	喰いつこう 食いつこう
くいつない	食いつない 食い繋い
くいつなが	食いつなが 食い繋が
くいつなぎ	食いつなぎ 食い繋ぎ
くいつなぐ	喰いつなぐ 食いつなぐ 食い繋ぐ
くいつなげ	食いつなげ 食い繋げ
くいつぶさ	喰い潰さ 食いつぶさ 食い潰さ
くいつぶし	食いつぶし 食い潰し
くいつぶす	食いつぶす 食い潰す
くいつめ	喰いつめ 食いつめ 食い詰め
くいとめ	くい止め 喰いとめ 喰い止め 食いとめ 食い止め 食止め
くいとめよう	くい止めよう 喰い止めよう 食い止めよう
くいとめる	くい止める 喰い止める 食いとめる 食い止める
くいやぶっ	食いやぶっ 食い破っ
くう	喰う 食う
くえ	喰え 食え
くえる	喰える 食える
くお	喰お 食お
くおう	喰おう 食おう
くぎっ	区切っ 句切っ
くぎり	区切り 句切り
くぎる	区切る 句切る
くくりつけ	くくり付け 括りつけ 括り付け
くくりつける	くくり付ける 括りつける 括り付ける
くぐりぬけ	くぐり抜け 潜り抜け
くぐりぬけよう	くぐり抜けよう 潜り抜けよう
くぐりぬける	くぐり抜ける 潜り抜ける
くさっ	クサっ 腐っ
くさむし	草むし 草生し
くさむす	草むす 草生す
くさり	クサり 腐り
くさる	クサる 腐る
くずおれ	崩折れ 頽れ
くずおれる	崩折れる 頽れる
くずれおち	崩れおち 崩れ落ち
くずれおちる	崩れおちる 崩れ落ちる
くずれさっ	崩れさっ 崩れ去っ
くずれさり	崩れさり 崩れ去り
くずれさる	崩れさる 崩れ去る
くずれさろう	崩れさろう 崩れ去ろう
くださ	下さ 降さ
くださーい	くださ〜い 下さーい
くだし	下し 降し
くだす	下す 降す
くだせ	下せ 降せ
くだそう	下そう 降そう
くだっ	下っ 下ッ
くだり	下り 降り
くちごもっ	口ごもっ 口籠っ 口籠もっ
くちごもる	口ごもる 口籠る
くちずさむ	口ずさむ 口遊む
くっ	刳っ 喰っ 繰っ 食っ
くつがえさ	覆えさ 覆さ
くつがえし	覆えし 覆し
くつがえす	覆えす 覆す
くつがえそう	覆えそう 覆そう
くどきおとさ	口説きおとさ 口説き落さ 口説き落とさ
くどきおとし	くどき落とし 口説き落し 口説き落とし
くどきおとす	くどき落とす 口説き落とす
くどきおとそう	くどき落とそう 口説き落とそう
くびりころし	くびり殺し 縊り殺し
くびれ	括れ 縊れ
くびれる	括れる 縊れる
くふ	喰ふ 食ふ
くべ	焚べ 焼べ
くま	汲ま 組ま 酌ま
くみ	汲み 組み 酌み
くみあがっ	組みあがっ 組み上がっ
くみあがり	組みあがり 組み上がり
くみあがる	組みあがる 組み上がる
くみあげ	くみ上げ 汲みあげ 汲み上げ 汲上げ 組みあげ 組み上げ
くみあげる	くみ上げる 汲みあげる 汲み上げる 組みあげる 組み上げる
くみあわさ	組みあわさ 組み合さ 組み合わさ 組合さ 組合わさ
くみあわされ	組み合され 組み合わされ
くみあわし	組み合し 組み合わし 組合し
くみあわす	組み合わす 組合す
くみあわせ	組みあわせ 組み合せ 組み合わせ 組合せ 組合わせ
くみあわせる	組みあわせる 組み合せる 組み合わせる 組合せる 組合わせる
くみあわせれ	組み合せれ 組み合わせれ 組合わせれ
くみいれ	くみ入れ 汲み入れ 組みいれ 組み入れ 組入れ
くみいれよう	組み入れよう 組入れよう
くみいれる	汲み入れる 組み入れる 組入れる
くみかえ	組みかえ 組み変え 組み換え 組み替え 組換え 組替え
くみかえる	組みかえる 組み変える 組み換える 組み替える 組換える 組替える
くみかわる	組み変わる 組み替わる
くみこま	汲みこま 汲み込ま 組みこま 組み込ま 組込ま
くみこみ	組みこみ 組み込み 組込み
くみこむ	汲み込む 組みこむ 組み込む 組込む
くみこめ	組みこめ 組み込め
くみこめる	組み込める 組込める
くみこん	汲み込ん 組みこん 組み込ん 組込ん
くみし	与し 組し 組みし
くみしい	組み敷い 組敷い
くみしか	組しか 組み敷か 組敷か
くみしき	組み敷き 組敷き
くみする	与する 組する 組みする
くみせ	与せ 組せ 組みせ
くみたて	組みたて 組み建て 組み立 組み立て 組立 組立て
くみたてよう	組み立てよう 組立てよう
くみたてる	組みたてる 組み立てる 組立てる
くみださ	くみ出さ 汲みださ 汲み出さ
くみだし	くみ出し 汲みだし 汲み出し
くみだす	くみ出す 汲みだす 汲み出す
くみだせる	くみ出せる 汲み出せる
くみつい	組みつい 組み付い 組付い
くみつか	組みつか 組み付か 組付か
くみつき	組みつき 組み付き
くみつく	組みつく 組み付く 組付く
くみつけ	組みつけ 組み付け 組付け
くみとっ	くみ取っ 汲みとっ 汲み取っ 酌み取っ
くみとめ	組みとめ 組み止め
くみとら	くみ取ら 汲みとら 汲み取ら 汲取ら
くみとり	くみ取り 汲みとり 汲み取り 汲取り 酌み取り
くみとる	くみ取る 汲みとる 汲み取る 汲取る 酌み取る
くみとれ	くみ取れ 汲みとれ 汲み取れ
くみとれる	くみ取れる 汲みとれる 汲み取れる
くみとろう	くみ取ろう 汲みとろう 汲み取ろう 汲取ろう
くみなおさ	組みなおさ 組み直さ
くみなおし	組みなおし 組み直し
くみなおす	組みなおす 組み直す
くみふせ	組み伏せ 組伏せ
くむ	汲む 組む 酌む
くめ	汲め 組め
くめる	汲める 組める
くも	拱も 組も
くもう	汲もう 組もう
くもっ	曇っ 雲っ
くもら	曇ら 雲ら
くもり	曇り 雲り
くやみ	悔み 悔やみ
くやむ	悔む 悔やむ
くやん	悔やん 悔ん
くらい	啖い 喰らい 食らい
くらいつい	喰らいつい 喰らい付い 食らいつい 食らい付い
くらいつか	喰らいつか 喰らい付か 食らいつか 食らい付か
くらいつき	喰らいつき 喰らい付き 食らいつき 食らい付き
くらいつく	喰らいつく 喰らい付く 食らいつく 食らい付く
くらいつこう	喰らいつこう 食らいつこう
くらう	啖う 喰らう 食らう
くらえ	啖え 喰らえ 食らえ
くらおう	喰らおう 食らおう
くらさ	暮さ 暮らさ
くらし	暗し 暮し 暮らし
くらす	暮す 暮らす
くらせ	暮せ 暮らせ
くらせる	暮せる 暮らせる
くらそう	暮そう 暮らそう
くらっ	喰らっ 食らっ
くらべ	比べ 競べ 較べ
くらべる	比べる 較べる
くらべれ	比べれ 較べれ
くらまし	晦まし 暗まし 眩まし
くらます	晦ます 暗ます 眩ます
くらみ	暗み 眩み
くらむ	暗む 眩む
くらわ	喰らわ 食らわ
くらわさ	喰らわさ 食さ 食らわさ
くらわし	喰らわし 食し 食らわし
くらわす	喰らわす 食す 食らわす
くらわせ	啖わせ 喰らわせ 食せ 食らわせ
くらわそう	喰らわそう 食そう 食らわそう
くらん	暗ん 眩ん
くり	刳り 繰り
くりあげ	くり上げ 繰り上げ 繰上げ
くりいれ	繰り入れ 繰入れ
くりいれる	繰り入れる 繰入れる
くりかえ	繰り替え 繰替え 繰返
くりかえさ	くり返さ 繰りかえさ 繰り返えさ 繰り返さ 繰返さ
くりかえし	くり返し 繰りかえし 繰り返し 繰返し
くりかえす	くり返す 繰りかえす 繰り返す 繰り返へす 繰返す
くりこさ	繰り越さ 繰越さ
くりこし	繰り越し 繰越し
くりこす	繰り越す 繰越す
くりこみ	くり込み 繰り込み 繰込み
くりこむ	くり込む 繰り込む
くりこん	くり込ん 繰り込ん
くりさがり	繰り下がり 繰下がり
くりさがる	繰り下がる 繰下がる
くりさげ	繰り下げ 繰下げ
くりさげる	繰り下げる 繰下げる
くりださ	くり出さ 繰り出さ 繰出さ
くりだし	くり出し 繰りだし 繰り出し 繰出し
くりだす	くり出す 繰りだす 繰り出す 繰出す
くりだそう	くり出そう 繰り出そう
くりぬい	くり抜い くり貫い 刳り抜い 刳り貫い 繰り抜い
くりぬか	くり抜か くり貫か 刳り抜か 刳り貫か 刳貫か 繰り抜か
くりぬき	くり抜き くり貫き 刳り抜き 刳り貫き
くりぬく	くり抜く くり貫く 刳り抜く 刳り貫く 繰り抜く
くりぬこう	くり抜こう 刳り抜こう
くりのべ	繰り延べ 繰延べ
くりのべる	繰り延べる 繰延べる
くりひろげ	くり広げ 繰りひろげ 繰り広げ 繰り拡げ 繰広げ
くりひろげる	くり広げる 繰りひろげる 繰り広げる 繰り拡げる 繰広げる
くる	来る 繰る
くるしみ	困しみ 苦しみ
くるしみもだえ	苦しみもだえ 苦しみ悶え
くるしみもだえる	苦しみもだえる 苦しみ悶える
くるしむ	困しむ 苦しむ
くるしめ	苦しめ 苦るしめ
くるべかし	転 転し
くるべかす	転 転す
くれ	呉れ 暮れ 来れ 繰れ
くれゆく	暮れゆく 暮れ行く
くれる	呉れる 暮れる 繰れる
くれれ	呉れれ 暮れれ
くわ	喰わ 食わ
くわえ	加え 加へ 咥え 銜え
くわえこむ	くわえ込む 咥え込む
くわえこん	くわえ込ん 加え込ん 咥え込ん
くわえとり	くわえ取り 銜え取り
くわえよう	加えよう 咥えよう
くわえる	加える 加へる 咥える 銜える
くわえれ	加えれ 加へれ 咥えれ
くわえろ	加えろ 咥えろ
くわさ	喰わさ 食わさ
くわし	喰わし 食わし
くわす	喰わす 食わす
くわせ	喰わせ 食わせ
くわわっ	加っ 加わっ 加わわっ
くわわら	加ら 加わら 加わわら
くわわり	加り 加わり 加わわり
くわわる	加る 加わる 加わわる
くわわれ	加れ 加われ
くん	来ん 汲ん 組ん 酌ん
くんじ	薫じ 訓じ
くんじる	薫じる 訓じる
くんずる	薫ずる 訓ずる
くんぜ	薫ぜ 訓ぜ
ぐうさ	寓さ 遇さ
ぐうし	寓し 遇し
ぐうす	寓す 遇す
ぐうする	寓する 遇する
ぐちっ	グチっ 愚痴っ
ぐちり	グチり 愚痴り
ぐちる	グチる 愚痴る
けいし	刑し 啓し 慶し 敬し
けいす	啓す 敬す
けいする	刑する 啓する 敬する
けおされ	気おされ 気圧され
けおとし	蹴落し 蹴落とし
けがす	汚す 瀆す 穢す
けころし	け殺し 蹴殺し
けしさる	消しさる 消し去る
けしされ	消しされ 消し去れ
けしさろう	消しさろう 消し去ろう
けしとめ	消しとめ 消し止め
けずり	ケズり 削り 梳り
けずりあい	削りあい 削り合い
けずりあう	削りあう 削り合う
けずりあっ	削りあっ 削り合っ
けずりおとさ	削り落さ 削り落とさ
けずりおとし	削り落し 削り落とし
けずりとっ	けずり取っ 削りとっ 削り取っ
けずりとら	削りとら 削り取ら
けずりとり	削りとり 削り取り
けずりとる	削りとる 削り取る
けずる	削る 梳る
けた	消 消た
けたおし	蹴たおし 蹴倒し
けだし	け出し 蹴出し
けち	消 消ち
けちらせ	蹴ちらせ 蹴散らせ
けっし	決し 結し
けっする	決する 結する
けっとばし	蹴っとばし 蹴っ飛ばし
けつ	消 消つ
けとばさ	蹴とばさ 蹴飛ばさ
けとばし	け飛ばし 蹴とばし 蹴飛ばし
けとばす	蹴とばす 蹴飛ばす
けばだち	ケバ立ち 毛羽立ち
けばだっ	毛ばだっ 毛羽立っ
けりあげ	蹴りあげ 蹴り上げ
けりあげる	蹴りあげる 蹴り上げる
けりおとし	けり落とし 蹴り落とし
けりおとす	けり落とす 蹴り落とす
けりこま	蹴りこま 蹴り込ま
けりこみ	蹴りこみ 蹴り込み
けりこむ	けり込む 蹴りこむ 蹴り込む
けりこん	蹴りこん 蹴り込ん
けりとばさ	蹴りとばさ 蹴り飛ばさ
けりとばし	蹴り跳ばし 蹴り飛ばし
けんし	検し 験し
けんする	検する 験する
げきし	檄し 激し
げきする	檄する 激する
げんじ	減じ 現じ
げんじよう	減じよう 現じよう
げんじる	減じる 現じる
げんずる	減ずる 現ずる
げんぜ	減ぜ 現ぜ
こい	乞い 恋い 扱い 放い 来い 漕い 請い
こいうけ	乞い受け 請い受け
こいこがれ	恋いこがれ 恋い焦がれ 恋い焦れ 恋焦がれ
こいこがれる	恋い焦がれる 恋焦がれる
こいねがい	乞い願い 請い願い
こいねがう	乞い願う 冀う 希う 請い願う
こいねがっ	こい願っ 乞い願っ 請い願っ
こいもとめ	乞い求め 請い求め
こう	乞う 恋う 請う 買う 飼う
こうし	効し 抗し 稿し 耗し 薨し
こうじ	困じ 嵩じ 昂じ 薨じ 講じ 高じ
こうじる	嵩じる 昂じる 薨じる 講じる 高じる
こうじれ	講じれ 高じれ
こうする	抗する 稿する 耗する
こうずる	薨ずる 講ずる
こうせ	抗せ 薨せ
こうむら	蒙ら 被ら
こうむり	蒙り 被り
こうむる	蒙る 被る
こえ	乞え 肥え 請え 超え 越え 踰え
こえで	超え出 越え出
こえでる	超え出る 越え出る
こえよう	超えよう 越えよう
こえる	肥える 超える 越える
こえれ	肥えれ 超えれ 越えれ
こえろ	超えろ 越えろ
こえん	超えん 越えん
こおう	乞おう 請おう
こおっ	凍っ 氷っ
こおら	凍ら 氷ら
こおりつい	凍りつい 凍り付い
こおりつか	凍りつか 凍り付か
こおりつき	凍りつき 凍り付き
こおりつく	凍りつく 凍り付く
こおる	凍る 氷る
こかす	倒かす 転かす
こが	榜が 漕が
こがす	焦がす 焦す
こきおろさ	こき下ろさ 扱き下ろさ
こきおろし	こき下ろし コキおろし 扱き下ろし
こきおろす	こき下ろす 扱き下ろす
こきつかい	こき使い 扱き使い
こきつかう	こき使う 扱き使う
こきつかっ	こき使っ 扱き使っ
こきつかわ	こき使わ 扱き使わ
こぎ	扱ぎ 漕ぎ
こぎだし	こぎ出し 漕ぎだし 漕ぎ出し
こぎだす	こぎ出す 漕ぎだす 漕ぎ出す
こぎつい	こぎ着い 漕ぎ着い
こぎつけ	こぎ着け 漕ぎつけ 漕ぎ付け 漕ぎ着け
こぎつけよう	こぎ着けよう 漕ぎつけよう 漕ぎ着けよう
こぎつける	こぎ着ける 漕ぎつける 漕ぎ付ける 漕ぎ着ける
こくし	刻し 剋し 哭し
こくする	刻する 剋する 哭する
こくっ	コクっ 告っ
こぐ	榜ぐ 漕ぐ
こけ	倒け 痩け 転け
こけむさ	コケむさ 苔むさ
こけむし	苔むし 苔生し
こけむす	コケむす 苔むす 苔生す
こげ	漕 漕げ 焦げ
こげつい	焦げつい 焦げ付い
こげつか	焦げつか 焦げ付か
こげつき	焦げつき 焦げ付き 焦付き
こげつく	焦げつく 焦げ付く 焦付く
こげる	漕げる 焦げる
こころがけ	心がけ 心懸け 心掛け
こころがけよ	心がけよ 心掛けよ
こころがける	心がける 心懸ける 心掛ける
こころがけれ	心がけれ 心掛けれ
こころざし	志ざし 志し
こころざす	志ざす 志す
こころみ	試 試み
こころゆく	心ゆく 心行く
こさ	漉さ 濾さ 超さ 越さ
こし	漉し 濾し 超し 越し 鼓し
こしかけ	腰かけ 腰掛け
こしかける	腰かける 腰掛ける
こしとっ	こし取っ 漉し取っ 濾しとっ 濾し取っ
こしとら	漉し取ら 濾しとら 濾し取ら
こしとり	こし取り 漉し取り 濾しとり 濾し取り
こしとる	こし取る 漉し取る 濾しとる 濾し取る
こじあけ	こじ空け こじ開け 抉じ開け
こす	漉す 濾す 超す 越す
こすりあわせ	こすり合わせ 擦り合わせ
こすりあわせる	こすり合せる こすり合わせる 擦り合わせる
こすりおとさ	こすり落とさ 擦り落とさ
こすりおとし	こすり落とし 擦り落とし
こすりおとす	こすり落とす 擦り落とす
こすりつけ	こすり付け 擦り付け
こすりつける	こすり付ける 擦り付ける
こすりとっ	こすり取っ 擦り取っ
こすりとら	こすり取ら 擦り取ら
こすりとり	こすり取り 擦り取り
こすりとる	こすり取る 擦り取る
こすれあう	こすれ合う 擦れ合う
こすれあっ	こすれ合っ 擦れ合っ
こそ	超そ 越そ
こそう	濾そう 越そう
こそぎおとし	こそぎ落とし 刮ぎ落とし
こそぎおとす	こそぎ落とす 刮ぎ落とす
こたえ	堪へ 応 応え 答え
こたえよ	応えよ 答えよ
こたえよう	応えよう 答えよう
こたえる	堪える 応える 答える
こたえれ	応えれ 答えれ
こっ	乞っ 凝っ 恋っ 請っ
ことかい	こと欠い 事欠い
ことかか	こと欠か 事欠か
ことかく	こと欠く 事欠く
こときれ	こと切れ 事切れ
こときれる	こと切れる 事切れる
ことたり	こと足り 事足り
ことたりる	こと足りる 事足りる
ことづかっ	言付かっ 託かっ
ことなっ	異っ 異なっ
ことなら	異なら 異ら
ことなり	異なり 異り
ことなる	異なる 異る 異ル
ことなれ	異なれ 異れ
ことほい	寿い 言祝い
ことほぎ	寿ぎ 言祝ぎ
ことほぐ	寿ぐ 言祝ぐ
ことよせ	こと寄せ 事寄せ
ことわっ	断っ 断わっ
ことわら	断ら 断わら 理ら
ことわり	断り 断わり
ことわる	断る 断わる 理る
ことわれ	断れ 断われ
ことわろう	断ろう 断わろう
こなせ	熟 熟せ
こなせる	熟せる 熟る
こねあげ	こね上げ 捏ね上げ
こねあげる	こね上げる 捏ね上げる
こねあわせ	こね合わせ 捏ね合わせ
こびへつらい	媚びへつらい 媚び諂い
こびへつらう	媚びへつらう 媚び諂う
こびへつらっ	媚びへつらっ 媚び諂っ
こびへつらわ	媚びへつらわ 媚び諂わ
こびりつい	こびり付い コビリつい
こびりつく	こびり付く こびり着く
こふ	乞ふ 恋ふ 請ふ 買ふ 飼ふ
こへ	乞へ 越へ
こぼす	溢す 零す
こぼれおち	こぼれ落ち 零れ落ち
こぼれおちる	こぼれ落ちる 零れ落ちる
こま	困 混ま 込ま
こみ	混み 込み
こみあい	こみ合い 混みあい 混み合い 込み合い
こみあう	混みあう 混み合う 込み合う
こみあげ	こみ上げ 込み上げ
こみあげる	こみ上げる 込み上げる
こみあっ	こみ合っ 混みあっ 混み合っ 込み合っ
こみあわ	混み合わ 込み合わ
こみいっ	混みいっ 混み入っ 込み入っ
こめ	篭め 籠め 込め
こめる	篭める 籠める 込める
こもっ	篭っ 篭もっ 籠っ 籠もっ 込もっ
こもら	篭もら 篭ら 籠もら 籠ら
こもり	篭もり 篭り 籠もり 籠り
こもる	篭もる 篭る 籠もる 籠る
こもれ	籠もれ 籠れ
こもろう	籠もろう 籠ろう
こやし	肥し 肥やし
こやす	肥す 肥やす
こやそう	肥そう 肥やそう
こら	凝ら 来ら
こらえ	コラえ 堪え
こらさ	凝さ 凝らさ 懲らさ
こらし	凝らし 懲らし
こり	凝り 懲り 樵り
こりかたまっ	こり固まっ 凝り固まっ
これ	凝れ 来れ
これる	來れる 来れる
ころがし	コロがし 転がし
ころがりおち	ころがり落ち 転がり落ち
ころがりおちる	ころがり落ちる 転がり落ちる
ころがりおとし	転がり落し 転がり落とし
ころがりこみ	転がりこみ 転がり込み
ころがりこむ	転がりこむ 転がり込む
ころがりこん	転がりこん 転がり込ん
ころげおちる	ころげ落ちる 転げ落ちる
ころげおとす	ころげ落とす 転げ落とす
ころげこみ	転げこみ 転げ込み
ころげまわっ	転げまわっ 転げ回っ
ころげまわり	転げまわり 転げ回り
ころげまわる	転げまわる 転げ回る
ころしあい	殺しあい 殺し合い
ころしあう	殺しあう 殺し合う
ころしあっ	殺しあっ 殺し合っ
ころしあわ	殺しあわ 殺し合わ
ころす	殺す 殺ろす
ころせ	殺せ 殺ろせ
こわ	乞わ 恋わ 請わ
こわさ	壊さ 毀さ
こわし	壊し 毀し
こわす	壊す 毀す
こわせ	壊せ 毀せ
こわばっ	強ばっ 強張っ
こわばら	強ばら 強張ら
こわばり	強ばり 強張り 硬ばり
こわばる	強ばる 強張る
こわれ	壊れ 毀れ
こん	混ん 込ん
ごうする	号する 合する
ごうせ	号せ 合せ
ござい	御ざい 御座い
ござら	御ざら 御座ら
ごまかさ	胡麻化さ 誤魔化さ
ごまかし	ゴマカし 胡魔化し 胡麻化し 誤魔化し
ごまかす	ゴマかす 誤魔化す
ごまかせ	ゴマかせ 誤魔化せ
ごまかそう	ゴマかそう 誤魔化そう
さ	仕 為
さい	割い 咲い 裂い
さいなん	苛ん 虐ん
さえ	不可 冴え
さえかえる	冴え返る 冴返る
さえぎら	遮ぎら 遮ら
さえぎる	遮ぎる 遮る
さえぎろう	遮ぎろう 遮ろう
さおさし	棹さし 棹し 棹差し
さおさす	棹さす 棹す 棹差す
さか	割か 咲か 裂か
さかえ	栄え 榮 榮え
さかえゆく	栄えゆく 栄え行く
さかだち	さか立ち 逆立ち
さかだっ	逆だっ 逆立っ
さかのぼっ	さか上っ 溯っ 遡っ
さかのぼら	溯ら 遡ら
さかのぼり	泝り 溯り 遡り
さかのぼる	泝る 溯る 遡る
さかのぼれ	溯れ 遡れ
さかのぼれる	溯れる 遡れる
さからい	逆い 逆らい
さからう	逆う 逆らう
さからえ	逆え 逆らえ
さからえる	逆える 逆らえる
さからっ	逆っ 逆らっ
さからわ	逆らわ 逆わ
さがさ	捜さ 探さ
さがし	捜し 探がし 探し
さがしあつめ	捜し集め 探し集め
さがしあて	捜しあて 捜し当て 探しあて 探し当て
さがしあてよう	捜し当てよう 探しあてよう 探し当てよう
さがしあてる	捜し当てる 探しあてる 探し当てる
さがしあるい	捜し歩い 探し歩い
さがしあるき	捜し歩き 探し歩き
さがしあるく	捜し歩く 探し歩く
さがしださ	捜し出さ 探しださ 探し出さ
さがしだし	さがし出し 捜しだし 捜し出し 探しだし 探し出し
さがしだす	さがし出す 捜しだす 捜し出す 探しだす 探し出す
さがしだせ	捜しだせ 捜し出せ 探し出せ
さがしだせる	捜し出せる 探し出せる
さがしだそう	さがし出そう 捜し出そう 探しだそう 探し出そう
さがしまわっ	捜しまわっ 捜し回っ 探しまわっ 探し回っ 探し廻っ
さがしまわり	捜しまわり 捜し回り 探しまわり 探し回り 探し廻り
さがしまわる	捜しまわる 捜し回る 探しまわる 探し回る 探し廻る
さがしもとめ	捜し求め 探しもとめ 探し求め
さがしもとめる	捜し求める 探し求める
さがす	捜す 探がす 探す
さがせ	捜 捜せ 探がせ 探せ
さがせる	捜せる 探せる
さがそう	捜そう 探そう
さがっ	サガっ 下がっ 退がっ
さがら	サガら 下がら 退がら
さがり	サガり 下がり
さがる	サガる 下がる 退がる
さがれ	サガれ 下がれ
さき	割き 咲き 裂き
さきがけ	先がけ 先駆け 先駈 先駈け 魁 魁け
さきがける	先がける 先駆ける
さきそめ	咲きそめ 咲き初め
さきそろう	咲きそろう 咲き揃う
さきそろっ	咲きそろっ 咲き揃っ
さきだた	先だた 先立た
さきだち	先だち 先ち 先立ち
さきだっ	先だっ 先っ 先立っ
さきだつ	先だつ 先立つ
さきだて	先だて 先て 先立て
さきだと	先だと 先と
さきひらく	咲き開く 裂き開く
さきほこら	咲きほこら 咲き誇ら
さきほこり	咲きほこり 咲き誇り
さきほこる	咲きほこる 咲き誇る
さきほこれ	咲きほこれ 咲き誇れ
さきみだれ	咲きみだれ 咲き乱れ 咲乱れ
さきみだれる	咲き乱れる 咲乱れる
さく	割く 咲く 裂く
さぐりあて	さぐり当て 探りあて 探り当て
さぐりあてよう	探りあてよう 探り当てよう
さぐりあてる	探りあてる 探り当てる
さけ	割け 咲け 裂け 避け
さけびあげ	叫びあげ 叫び上げ
さけよ	咲けよ 裂けよ 避けよ
さける	割ける 咲ける 裂ける 避ける
さけれ	裂けれ 避けれ
さけん	叫ん 裂けん
さげ	下げ 提げ 退げ
さげる	サゲる 下げる 提げる 退げる
さこう	割こう 咲こう 裂こう
ささ	刺さ 射さ 差さ 指さ 挿さ 止さ 注さ 鎖さ
ささえあい	ささえ合い 支えあい 支え合い
ささえあう	支えあう 支え合う
ささえあえる	支えあえる 支え合える
ささえあおう	支えあおう 支え合おう
ささえあっ	支えあっ 支え合っ
ささげ	さゝげ 捧げ 献げ
ささげもた	捧げもた 捧げ持た
ささげもっ	ささげ持っ 捧げもっ 捧げ持っ
ささげもつ	ささげ持つ 捧げもつ 捧げ持つ
ささげよう	捧げよう 献げよう
ささげる	捧げる 献げる
ささっ	刺さっ 差さっ 挿さっ
ささやき	さゝやき 囁き
ささやきあい	ささやき合い 囁き合い
ささやきあっ	ささやき合っ 囁きあっ 囁き合っ
ささら	刺さら 差さら 挿さら
ささる	刺さる 挿さる
さされ	刺され 差され
さし	刺し 射し 差し 指し 挿し 注し 鎖し
さしあげ	さし上げ 刺し上げ 差しあげ 差し上げ 差上 差上げ
さしあげる	さし上げる 差しあげる 差し上げる 差上げる
さしあたっ	さし当たっ さし当っ 差しあたっ 差し当たっ
さしあたり	さし当り 差し当たり 差し当り 差当たり 差当り
さしいれ	さし入れ 刺し入れ 差し入れ 差入れ 指し入れ 挿し入れ
さしいれる	刺し入れる 差し入れる 差入れる 指し入れる 挿し入れる
さしおい	さし置い 差し置い 差置い
さしおか	差し置か 差置か
さしおき	差し置き 差置き
さしおく	さし置く 差し置く 差置く
さしおさえ	差し押え 差し押さえ 差押え 差押さえ
さしおさえる	差し押える 差し押さえる 差押える 差押さえる
さしかえ	差しかえ 差し変え 差し換え 差し替え 差換え 差替え 挿し替え
さしかえる	刺し替える 差しかえる 差し変える 差し換える 差し替える 差替える 挿し替える
さしかかっ	差しかかっ 差し掛かっ 差し掛っ
さしかかり	さし掛かり 差しかかり 差し掛かり
さしかかる	差しかかる 差し掛かる 差掛る
さしかかろう	差しかかろう 差し掛かろう
さしかけ	差し掛け 差掛け
さしかわり	差し代わり 差し替わり
さしこま	射し込ま 差しこま 差し込ま 指し込ま 挿しこま 挿し込ま
さしこみ	さし込み 刺しこみ 射しこみ 射し込み 差しこみ 差し込み 差込み 指し込み 挿しこみ 挿し込み
さしこむ	刺しこむ 射しこむ 射し込む 差しこむ 差し込む 差込む 指し込む 挿しこむ 挿し込む
さしこめ	射し込め 差し込め 挿し込め
さしこもう	差しこもう 差し込もう
さしころし	刺し殺し 刺殺し
さしころす	刺し殺す 刺殺す
さしこん	さし込ん 刺しこん 射しこん 射し込ん 差しこん 差し込ん 差込ん 指し込ん 挿しこん 挿し込ん
さししめし	さし示し 差し示し 指し示し
さししめす	さし示す 差し示す 指ししめす 指し示す
さしせまっ	さし迫っ 差し迫っ
さしせまり	さし迫り 差し迫り
さしせまる	さし迫る 差し迫る 差迫る
さしたて	差し立て 差立て
さしたてる	差し立てる 差立てる
さしださ	さし出さ 差しださ 差し出さ 差出さ
さしだし	さし出し 差しだし 差し出し 差出し 指し出し
さしだす	さし出す 差しだす 差し出す 差出す
さしだせ	差し出せ 差出せ
さしだそう	差し出そう 差出そう
さしちがえ	刺しちがえ 刺し違え 刺違え 差し違え 差違え
さしちがえよう	刺し違えよう 差し違えよう
さしちがえる	刺しちがえる 刺し違える 差し違える
さしちがえろ	刺し違えろ 差し違えろ
さしつかえ	差しつかえ 差し支え 差支え
さしつかえる	差しつかえる 差し支える 差支える
さしつかわさ	差し遣わさ 差遣わさ
さしつかわす	差し遣わす 差遣わす
さしで	さし出 差し出
さしとめ	さし止め 差し止め 差し留め 差止め
さしとめる	差しとめる 差し止める
さしのべ	さし伸べ 差しのべ 差し伸べ
さしのべよう	差しのべよう 差し伸べよう
さしのべる	差しのべる 差し伸べる 差し延べる
さしはさま	さし挟ま 差しはさま 差し挟ま 挿し挟ま
さしはさみ	差しはさみ 差し挟み
さしはさむ	さし挟む 差しはさむ 差し挟む 指し挟む
さしはさめ	差し挟め 挿し挟め
さしはさもう	差しはさもう 差し挟もう
さしはさん	差しはさん 差し挟ん 挿し挟ん
さしひかえ	さし控え 差し控え 差控え
さしひかえる	差し控える 差控える
さしまわし	さし回し 差し回し
さしむけ	さし向け 差し向け 差向け 指し向け
さしむける	差し向ける 差向ける 指し向ける
さしもどさ	差し戻さ 差戻さ
さしもどし	差し戻し 差戻し
さしもどす	差し戻す 差戻す
さしわたさ	さし渡さ 差し渡さ
さしわたし	さし渡し 差し渡し
さす	刺す 射す 差す 指す 挿す 注す 鎖す
さすら	摩ら 撫ら
さずかっ	授かっ 授っ
さずかり	授かり 授り
さずかる	授かる 授る
させ	刺せ 差せ 指せ 挿せ 鎖せ
させる	刺せる 差せる 指せる 挿せる
さそいあっ	誘いあっ 誘い合っ
さそいかけ	誘いかけ 誘い掛け
さそいかける	誘いかける 誘い掛ける
さそいこま	誘いこま 誘い込ま
さそいこみ	誘いこみ 誘い込み
さそいこむ	誘いこむ 誘い込む
さそいこもう	誘いこもう 誘い込もう
さそいこん	誘いこん 誘い込ん
さそいだし	さそい出し 誘いだし 誘い出し 誘ひ出し
さそいだす	誘いだす 誘い出す 誘ひ出す
さそいだそう	誘いだそう 誘い出そう
さそう	刺そう 差そう 指そう 挿そう 誘う
さだまっ	定っ 定まっ
さだまら	定まら 定ら
さだまり	定まり 定り
さだまる	定まる 定る
さっ	去っ 往っ
さっぴい	差っぴい 差っ引い
さつく	授 授く
さつけ	授 授け
さとし	悟し 諭し
さとす	悟す 諭す
さとっ	悟っ 覚っ
さとら	悟ら 覚ら
さとり	悟り 覚り
さとる	悟る 覚る
さとれ	悟れ 覚れ
さばい	捌い 裁い
さばか	捌か 裁か
さばき	審き 捌き 裁き
さばく	捌く 裁く
さばけ	捌け 裁け
さばける	捌ける 裁ける
さばこう	捌こう 裁こう
さび	寂び 銹び 錆び
さびつい	さび付い 錆つい 錆びつい 錆び付い 錆付い
さびつか	錆びつか 錆び付か 錆付か
さびつき	さび付き 錆びつき 錆び付き
さびつく	さび付く 錆つく 錆びつく 錆び付く
さびれ	寂びれ 寂れ
さまさ	冷まさ 覚さ 覚まさ 醒まさ
さまし	冷まし 覚し 覚まし 醒し 醒まし
さます	冷ます 覚す 覚ます 醒す 醒ます
さませ	冷ませ 覚ませ
さまそう	冷まそう 覚そう 覚まそう 醒まそう
さまたげよう	妨げよう 碍げよう
さまよい	さ迷い 彷徨い
さまよう	さ迷う 彷徨う
さまよえ	さ迷え 彷徨え
さまよっ	さ迷っ 彷徨っ
さめ	冷 冷め 褪め 覚め 醒め
さめよう	覚めよう 醒めよう
さめる	冷める 覚める 醒める
さめれ	覚めれ 醒めれ
さら	去ら 往ら
さらい	拐い 攫い 浚い
さらう	拐う 攫う 浚う
さらえ	攫え 浚え
さらおう	拐おう 攫おう 浚おう
さらけださ	さらけ出さ 曝け出さ
さらけだし	さらけ出し 晒け出し 曝け出し
さらけだす	さらけ出す 晒け出す 曝け出す
さらさ	晒さ 曝さ
さらし	晒し 曝し
さらす	晒す 曝す
さらせ	晒せ 曝せ
さらせる	晒せる 曝せる
さらっ	拐っ 攫っ 浚っ
さらわ	拐わ 攫わ 浚わ
さりゆく	去りゆく 去り行く
さわい	騒い 騷い
さわがす	騒がす 鬧がす
さわぎ	騒ぎ 騷ぎ
さわぎたて	騒ぎたて 騒ぎ立て 騒立て
さわぎたてる	騒ぎたてる 騒ぎ立てる
さわぐ	騒ぐ 騷ぐ
さわっ	触っ 障っ
さわら	触ら 障ら
さわり	触り 障り
さわる	触る 障る
さんし	参し 産し 算し
さんじ	参じ 散じ
さんじる	参じる 散じる
さんする	参する 産する 算する
さんずる	参ずる 散ずる
さんせ	参せ 産せ
さんぜ	参ぜ 散ぜ
ざし	坐し 座し
ざす	坐す 座す
ざする	坐する 座する
ざせ	坐せ 座せ
ざわつか	ザワつか 騒つか
し	仕 為
しあう	し合う 試合う
しあがっ	し上がっ 仕上がっ 仕上っ
しあがら	仕上がら 仕上ら
しあがり	仕上がり 仕上り
しあがる	し上がる 仕上がる 仕上る
しあげ	仕あげ 仕上げ
しい	布い 強 強い 強ひ 敷い 施い
しいる	強いる 強ひる 強る
しいれ	し入れ 仕入 仕入れ 強いれ
しいれる	仕入れる 強いれる
しおくる	し送る 仕送る
しおれ	凋れ 萎れ
しか	布か 敷か 施か 藉か
しかえさ	し返さ 仕返さ
しかえし	し返し 仕返し
しかえす	し返す 仕返す
しかけ	仕かけ 仕懸け 仕掛 仕掛け
しかけよう	仕掛けよう 仕掛よう
しかける	仕かける 仕掛ける
しかっ	しか 叱っ
しから	叱ら 呵ら 然ら
しかり	叱り 呵り 然 然り
しかりつけ	叱りつけ 叱り付け
しかりつける	叱りつける 叱り付ける
しかりとばさ	叱りとばさ 叱り飛ばさ
しかりとばし	しかり飛ばし 叱りとばし 叱り飛ばし
しかりとばす	しかり飛ばす 叱りとばす 叱り飛ばす
しかる	叱る 呵る 然 然る
しかれ	叱れ 然れ
しき	布き 敷き 施き
しきつめ	敷きつめ 敷き詰め 敷詰め
しきつめる	敷きつめる 敷き詰める
しきり	仕切り 頻り
しく	布く 敷く 施く
しけ	布け 敷け 時化
しける	敷ける 時化る 湿気る
しげっ	繁っ 茂っ
しげら	繁ら 茂ら
しげり	繁り 茂り
しげる	繁る 茂る
しこう	布こう 敷こう
しこま	し込ま 仕込ま
しこもう	し込もう 仕込もう
しこん	し込ん シこん 仕込ん
しごい	シゴい 扱い
しごか	シゴか 扱か
しごき	シゴき 扱き
しごく	シゴく 扱く
しし	嗣し 死し 資し
しする	嗣する 死する 資する
しずまっ	鎮まっ 静まっ
しずまら	寝ら 鎮まら 鎮ら 静まら
しずまり	寝り 鎮まり 鎮り 静まり
しずまりかえっ	鎮まり返っ 静まりかえっ 静まり返っ
しずまりかえら	鎮まりかえら 静まり返ら
しずまりかえり	鎮まり返り 静まりかえり 静まり返り
しずまりかえる	静まりかえる 静まり返る
しずまる	鎮まる 鎮る 静まる
しずまれ	鎮まれ 静まれ
しずみこま	沈みこま 沈み込ま
しずみこみ	沈みこみ 沈み込み
しずみこむ	沈みこむ 沈み込む
しずみこん	沈みこん 沈み込ん
しずみゆく	沈みゆく 沈み行く
しずめ	沈め 鎮め 静め
しずめよ	沈めよ 鎮めよ
しずめよう	沈めよう 鎮めよう 静めよう
しずめる	沈める 鎮める 静める
しずめれ	沈めれ 鎮めれ
しずめん	沈めん 鎮めん
しせ	死せ 資せ
したがい	従い 從い 遵い 随い 順い
したがう	従う 從う 率う 遵う 随う 順う
したがえ	従え 随え
したがえる	従える 随える
したがおう	従おう 従がおう
したがっ	従っ 率っ 遵っ 随っ 隨っ 順っ
したがへ	従へ 隨へ
したがわ	従がわ 従わ 遵わ 随わ 順わ
したごう	率う 随う 順う
したごふ	従ふ 随ふ
したしめ	親しめ 親め
したたりおち	したたり落ち 滴り落ち
したたりおちる	したたり落ちる 滴り落ちる
したて	し立て 仕たて 仕立 仕立て
したてあがっ	仕立てあがっ 仕立て上がっ
したてあげ	仕立てあげ 仕立て上げ
したてあげよう	仕立てあげよう 仕立て上げよう
したてあげる	仕立てあげる 仕立て上げる
したてる	仕立てる 仕立る
したまわっ	下まわっ 下回っ
したまわり	下まわり 下回り 下廻り
したまわる	下まわる 下回る 下廻る
しっ	報っ 知っ 知ッ 識っ
しっし	叱し 失し
しつけ	仕付け 躾 躾け
しとげ	し遂げ 仕遂げ
しとげる	し遂げる 仕遂げる
しとめ	仕止め 仕留め
しとめよう	仕止めよう 仕留めよう
しとめる	仕とめる 仕留める
しにかかっ	死にかかっ 死に掛かっ
しにかける	死にかける 死に掛ける
しにたえ	死にたえ 死に絶え
しのい	シノい 凌い
しのぎ	シノぎ 凌ぎ
しのぐ	シノぐ 凌ぐ
しのげ	シノげ 凌 凌げ
しのごう	シノごう 凌ごう
しのば	偲ば 忍ば
しのび	偲び 忍び
しのびこま	忍びこま 忍び込ま
しのびこみ	しのび込み 忍びこみ 忍び込み
しのびこむ	忍びこむ 忍び込む
しのびこん	しのび込ん 忍びこん 忍び込ん
しのびなく	しのび泣く 忍び泣く
しのびよっ	忍びよっ 忍び寄っ
しのびより	忍びより 忍び寄り
しのびよる	しのび寄る 忍びよる 忍び寄る
しのぶ	偲ぶ 忍ぶ
しのべ	偲べ 忍べ
しのべる	偲べる 忍べる
しのん	偲ん 忍ん
しはらい	し払い 支払い
しはらえ	支払 支払え
しばりあげ	しばり上げ 縛りあげ 縛り上げ
しばりあげる	縛りあげる 縛り上げる
しばりつけ	縛りつけ 縛り付け
しばりつけよう	縛りつけよう 縛り付けよう
しばりつける	縛りつける 縛り付ける
しばれる	凍れる 縛れる
しびれ	シビれ 痺れ
しびれる	シビれる シビレる 痺れる
しぼっ	搾っ 絞っ
しぼま	凋ま 萎ま
しぼみ	凋み 萎み
しぼむ	凋む 萎む
しぼら	搾ら 絞ら
しぼり	搾り 絞り
しぼりあげ	搾り上げ 絞り上げ
しぼりあげる	しぼり上げる 絞りあげる 絞り上げる
しぼりこま	絞りこま 絞り込ま
しぼりこみ	しぼり込み 絞りこみ 絞り込み
しぼりこむ	絞りこむ 絞り込む
しぼりこめ	絞りこめ 絞り込め
しぼりこもう	絞りこもう 絞り込もう
しぼりこん	しぼり込ん 絞りこん 絞り込ん
しぼりださ	しぼり出さ 搾り出さ 絞りださ 絞り出さ
しぼりだし	しぼり出し 搾り出し 絞り出し
しぼりだす	しぼり出す 搾り出す 絞りだす 絞り出す
しぼりとっ	搾りとっ 搾り取っ 絞りとっ 絞り取っ
しぼりとら	しぼり取ら 搾りとら 搾り取ら 絞り取ら
しぼりとり	搾り取り 絞りとり
しぼりとる	しぼり取る 搾りとる 搾り取る 絞り取る
しぼりとろう	搾り取ろう 絞りとろう 絞り取ろう
しぼる	搾る 絞る
しぼれ	搾れ 絞れ
しぼれる	搾れる 絞れる
しぼん	凋ん 萎ん
しまい	仕舞い 納い 終い
しまいこま	しまい込ま 仕舞い込ま
しまいこみ	しまい込み 仕舞い込み
しまいこん	しまい込ん 仕舞い込ん
しまう	仕舞う 蔵う
しまっ	仕舞っ 納っ 絞まっ 締っ 締まっ 蔵っ 閉まっ
しまふ	了ふ 仕舞ふ
しまら	絞まら 締まら 締ら 閉まら
しまり	絞まり 締まり 締り 閉まり
しまる	絞まる 締まる 締る 閉まる
しまれ	締まれ 閉まれ
しみ	凍み 染 染み 沁み 泌み 浸み 滲 滲み
しみいっ	しみ入っ 染み入っ
しみいる	しみ入る 染みいる 染み入る 沁みいる 沁み入る
しみこま	しみ込ま 染みこま 染み込ま 染込ま 沁み込ま 浸みこま 浸み込ま
しみこみ	しみ込み 染みこみ 染み込み 浸みこみ 浸み込み
しみこむ	しみ込む 染みこむ 染み込む 染込む 沁み込む 浸みこむ 浸み込む
しみこん	しみ込ん 染みこん 染み込ん 沁みこん 沁み込ん 浸みこん 浸み込ん
しみださ	染みださ 染み出さ
しみだし	染みだし 染み出し 沁み出し 浸み出し
しみだす	染み出す 沁み出す 浸み出す
しみつい	染みつい 染み付い 染み着い 沁みつい
しみつき	染みつき 染み付き
しみつく	染みつく 染み付く
しみで	しみ出 染み出
しみでる	しみ出る 染み出る 沁み出る 浸み出る
しみとおる	しみ通る 染み透る 染み通る 滲み透る
しみる	凍みる 染みる 染る 沁みる
しむけ	し向け 仕向け
しむける	し向ける 仕向ける
しめ	〆 〆め 占め 搾 絞め 緊め 緊縛 締め 閉め
しめあげ	絞めあげ 締めあげ 締め上げ 締上げ
しめあげる	絞めあげる 締めあげる 締め上げる
しめおとさ	絞め落とさ 締め落とさ
しめおとし	絞め落とし 締め落とし
しめおとす	絞め落とす 締め落とす
しめかため	締め固め 締固め
しめかためる	締め固める 締固める
しめきっ	締め切っ 締切っ
しめきら	締め切ら 締切ら 閉め切ら
しめきり	しめ切り 締め切り 締切り
しめきる	締め切る 締切る 閉め切る
しめくくっ	締めくくっ 締め括っ
しめくくら	締めくくら 締め括ら
しめくくり	締めくくり 締め括り
しめくくる	締めくくる 締め括る
しめころさ	絞め殺さ 絞殺さ 締め殺さ
しめころし	しめ殺し 絞め殺し 絞殺し 締め殺し
しめころす	絞め殺す 締め殺す
しめころそう	絞め殺そう 締め殺そう
しめさ	湿さ 示さ 示めさ
しめし	湿し 示し 示めし
しめしあわせ	しめし合わせ 示し合せ 示し合わせ
しめす	湿す 示す 示めす
しめせ	示 示せ
しめせよう	示せよう 示よう
しめださ	しめ出さ 締め出さ 閉め出さ
しめだし	締め出し 閉め出し
しめだす	しめ出す 締め出す 閉め出す
しめだそう	締め出そう 閉め出そう
しめつけ	締めつけ 締め付け 締付け
しめつけよう	締めつけよう 締め付けよう
しめつける	締めつける 締め付ける 締付ける
しめなおし	締めなおし 締め直し
しめなおす	締めなおす 締め直す
しめよう	シメよう 占めよう 絞めよう 締めよう 閉めよう
しめる	〆る シメる 占める 搾る 湿る 絞める 緊縛る 締める 閉める
しめれ	占めれ 湿れ 締めれ 閉めれ
しめろ	絞めろ 締めろ 閉めろ
しゃし	射し 捨し 謝し
しゃしゃりで	しゃしゃり出 シャシャリ出
しゃする	射する 捨する 謝する
しゃせ	射せ 謝せ
しゃれこむ	しゃれ込む 洒落込む
しゅうし	修し 執し
しゅうする	修する 執する
しゅくし	宿し 祝し
しゅくす	宿す 祝す
しゅくする	宿する 祝する
しゅくせ	宿せ 祝せ
しょうさ	称さ 稱さ
しょうし	称し 稱し 証し 誦し 賞し 頌し
しょうじ	招じ 生じ 請じ
しょうじいれ	招じ入れ 請じ入れ
しょうじる	招じる 生じる
しょうす	称す 稱す
しょうする	称する 稱する 証する 誦する 賞する 頌する
しょうすれ	称すれ 稱すれ 証すれ 誦すれ
しょうずる	生ずる 請ずる
しょうせ	称せ 稱せ 証せ 誦せ 賞せ
しょうぜ	生ぜ 請ぜ
しょくし	喰し 嘱し 植し 食し
しょくする	喰する 嘱する 植する 食する
しょげかえっ	しょげ返っ 悄気返っ
しょし	処し 書し 署し 處し
しょする	処する 書する 署する 處する
しょせ	処せ 書せ 署せ 處せ
しら	報ら 知ら 識ら
しらけ	シラけ 白け
しらける	シラケる 白ける
しらさ	報さ 知らさ
しらし	報し 知らし
しらべ	検べ 調べ
しらべあげ	調べあげ 調べ上げ
しらべあげる	調べあげる 調べ上げる
しり	知り 識り
しりあい	知りあい 知り会い 知り合い 識りあい
しりあう	知りあう 知り会う 知り合う
しりあえる	知りあえる 知り合える
しりあっ	知りあっ 知り会っ 知り合っ
しりそめ	知りそめ 知り初め
しりぞけ	斥け 退け
しりぞけよ	斥けよ 退けよ
しりぞけよう	斥けよう 退けよう
しりぞける	斥ける 退ける
しる	知る 識る
しるさ	印さ 徴さ 標さ 記さ 誌さ
しるし	印し 徴し 標し 記し 誌し
しるす	印す 徴す 標す 記す 誌す
しるせ	印せ 記せ 誌せ
しるそ	印そ 標そ
しれる	痴れる 知れる
しろしめす	知ろしめす 知ろし召す
しわけ	し分け 仕分け
しわける	し分ける 仕分ける
しん	死ん 知ん
しんじ	信じ 進じ
しんじあい	信じあい 信じ合い
しんじあう	信じあう 信じ合う
しんじあえ	信じあえ 信じ合え
しんじあえる	信じあえる 信じ合える
しんじあっ	信じあっ 信じ合っ
しんじこま	信じこま 信じ込ま
しんじこまさ	信じこまさ 信じ込まさ
しんじこみ	信じこみ 信じ込み
しんじこむ	信じこむ 信じ込む
しんじこん	信じこん 信じ込ん
しんずれ	信ずれ 進ずれ
しんぜ	信ぜ 進ぜ
しんぜよ	信ぜよ 進ぜよ
じさ	侍さ 辞さ
じし	侍し 持し 辞し
じす	侍す 辞す
じする	侍する 持する 治する 辞する
じせ	侍せ 持せ 辞せ
じまい	了い 仕舞い 終い
じまう	了う 仕舞う
じまえ	了え 仕舞え 終え
じまっ	収っ 終っ
じまは	了は 仕舞は
じまへ	了へ 仕舞へ 藏へ
じまわ	了わ 仕舞わ 終わ
じゅんじ	准じ 殉じ 準じ 順じ
じゅんじよう	殉じよう 準じよう
じゅんじる	准じる 殉じる 準じる
じゅんずる	准ずる 殉ずる 準ずる 順ずる
じゅんずれ	準ずれ 順ずれ
じゅんぜ	准ぜ 殉ぜ 準ぜ 順ぜ
じゅんぜよ	准ぜよ 準ぜよ
じょさ	叙さ 除さ
じょし	叙し 序し 恕し 除し
じょす	叙す 除す
じょする	叙する 除する
じょせ	叙せ 序せ 除せ
じんどっ	陣どっ 陣取っ
じんどり	陣どり 陣取り
じんどる	陣どる 陣取る
すい	吸い 喫い 好い 抄い 梳い 漉い 透い 鋤い
すいあげる	吸いあげる 吸い上げる
すいこま	吸いこま 吸い込ま
すいこみ	吸いこみ 吸い込み 吸込み
すいこむ	吸いこむ 吸い込む 吸込む
すいこん	吸いこん 吸い込ん 吸込ん
すいださ	吸いださ 吸い出さ
すいだし	吸いだし 吸い出し
すいだす	吸いだす 吸い出す
すいつい	吸いつい 吸い付い 吸付い
すいつか	吸いつか 吸い付か
すいつき	吸いつき 吸い付き 吸付き
すいつく	吸いつく 吸い付く
すいつけ	吸いつけ 吸い付け 吸付け
すいつける	吸い付ける 吸付ける
すいとっ	吸いとっ 吸い取っ
すいとら	吸いとら 吸い取ら
すいとり	吸いとり 吸い取り
すいとる	吸いとる 吸い取る
すいよせ	吸いよせ 吸い寄せ
すう	吸う 喫う
すえ	吸え 据 据え 饐え
すえつけ	据えつけ 据え付け 据ゑつけ 据付け
すえつける	据えつける 据え付ける 据付ける
すえる	吸える 据える
すか	好か 梳か 漉か 透か 鋤か
すかさ	空かさ 賺さ 透かさ
すかし	スカし 空かし 透かし 透し
すかす	スカす 空かす 透かす 透す
すがりつい	すがり付い 縋りつい 縋り付い
すがりつき	すがり付き 縋り付き
すがりつく	すがり付く 縋りつく 縋り付く
すき	好き 抄き 梳き 漉き 透き 鋤き
すきあっ	好きあっ 好き合っ
すきいれ	すき入れ 漉き入れ
すきかえし	すき返し 漉き返し 鋤き返し 鋤返し
すきこのん	好きこのん 好き好ん
すきこま	漉き込ま 鋤き込ま
すきこみ	すき込み 漉き込み 鋤き込み
すきこむ	すき込む 漉き込む 鋤き込む
すきこん	すき込ん 漉き込ん 鋤き込ん
すきとおっ	すき通っ 透きとおっ 透き通っ
すきとおり	透きとおり 透き通り
すきとおる	透きとおる 透き通る 透通る
すきなおし	すき直し 漉き直し
すぎ	過 過ぎ
すぎさっ	すぎ去っ 過ぎさっ 過ぎ去っ
すぎさり	すぎ去り 過ぎさり 過ぎ去り
すぎさる	すぎ去る 過ぎさる 過ぎ去る
すぎゆき	過ぎゆき 過ぎ行き
すぎゆく	過ぎゆく 過ぎ行く
すぎる	過ぎる 過る
すく	好く 抄く 梳く 漉く 透く 鋤く
すくい	巣くい 巣喰い 巣食い 掬い 救い
すくいあげ	すくい上げ 掬いあげ 掬い上げ 救いあげ 救い上げ
すくいあげよう	すくい上げよう 掬い上げよう
すくいあげる	すくい上げる 掬いあげる 掬い上げる 救いあげる 救い上げる
すくいださ	すくい出さ 掬い出さ 救いださ 救い出さ
すくいだし	掬い出し 救いだし 救い出し
すくいだす	すくい出す 掬い出す 救いだす 救い出す
すくいだせ	すくい出せ 救いだせ 救い出せ
すくいだせる	救いだせる 救い出せる
すくいだそう	救いだそう 救い出そう
すくいとっ	すくい取っ 掬いとっ 掬い取っ 救い取っ
すくいとら	すくい取ら 掬い取ら 救いとら 救い取ら
すくいとり	すくい取り 掬い取り
すくいとる	すくい取る すくい捕る 掬いとる 掬い取る 救いとる 救い取る
すくいとれ	すくい取れ 掬い取れ
すくう	巣くう 巣喰う 巣食う 掬う 救う
すくえ	掬え 救え
すくえる	掬える 救える
すくおう	掬おう 救おう
すくっ	巣くっ 巣喰っ 巣食っ 掬っ 救っ
すくは	援は 救は
すくふ	巣喰ふ 巣食ふ 救ふ
すくみあがっ	すくみ上がっ すくみ上っ 竦みあがっ 竦み上がっ
すくわ	巣食わ 掬わ 援わ 救わ
すぐれ	傑れ 優れ 卓れ 秀れ
すぐれる	優れる 勝れる
すけ	梳け 透け
すける	梳ける 透ける
すげかえ	すげ換え すげ替え 挿げ替え
すげかえよう	すげ替えよう 挿げ替えよう
すげかえる	すげ換える すげ替える 挿げ替える
すごさ	過ごさ 過さ
すごし	過ごし 過し
すごす	過ごす 過す
すごせ	過ごせ 過せ
すごせる	過ごせる 過せる
すごみ	スゴみ 凄み
すじばっ	筋ばっ 筋張っ
すすい	洗い 漱い 雪い
すすが	漱が 雪が
すすぎ	漱ぎ 雪ぎ
すすぐ	洗ぐ 漱ぐ 雪ぐ
すすげ	漱げ 雪げ
すすみで	進みで 進み出
すすみでよう	進みでよう 進み出よう
すすめ	すヽめ ススめ 勧め 奨め 奬め 推め 薦め 進め
すすめよ	勧めよ 進めよ
すすめよう	勧めよう 薦めよう 進めよう
すすめる	ススめる 勧める 奨める 奬める 推める 薦める 進める
すすめれ	勧めれ 進めれ
すすめん	勧めん 進めん
すすりない	すすり泣い 啜り泣い
すすりなき	すすり泣き 啜り泣き
すだち	巣だち 巣立ち
すだっ	巣だっ 巣立っ
すっ	スっ 刷っ 吸っ 喫っ 掏っ 摺っ 擂っ 擦っ 磨っ
すっとび	すっ飛び 素ッ飛び
すっとん	すっ飛ん 素っ飛ん
すっぱぬい	すっぱ抜い スッパ抜い
すっぱぬか	すっぱ抜か スッパ抜か
すっぱぬき	すっぱ抜き スッパ抜き
すっぱぬく	すっぱ抜く スッパ抜く
すて	捨 捨て 棄て
すておい	捨ておい 捨て置い
すておく	捨ておく 捨て置く 捨置く
すておけ	捨ておけ 捨て置け
すてさっ	捨てさっ 捨て去っ 棄て去っ
すてさら	捨てさら 捨て去ら
すてさり	捨てさり 捨て去り 棄て去り
すてさる	捨て去る 棄て去る
すてされ	捨てされ 捨て去れ
すてよ	捨てよ 棄てよ
すてよう	捨てよう 棄てよう
すてる	捨てる 捨る 棄てる
すてれ	捨てれ 棄てれ
すてろ	捨てろ 棄てろ
すてん	捨てん 捨ん 棄てん
すねる	スネる 拗ねる
すべ	統べ 総べ
すべっ	スベっ 滑っ
すべら	スベら 滑ら
すべり	スベり 滑べり 滑り 辷り
すべりおち	すべり落ち 滑り落ち 辷り落ち
すべりおちる	すべり落ちる 滑り落ちる
すべりおとす	すべり落とす 滑り落とす
すべりおり	すべり降り 滑り下り 滑り降り
すべりおりる	すべり下りる すべり降りる 滑り下りる 滑り降りる
すべりこま	すべり込ま 滑り込ま
すべりこみ	すべり込み 滑りこみ 滑り込み 辷り込み
すべりこむ	滑りこむ 滑り込む
すべりこん	すべり込ん 滑りこん 滑り込ん
すべる	スベる 滑る 統べる 総べる
すべれ	スベれ 滑れ
すま	住ま 栖ま 棲ま 清ま 済ま 澄ま
すまい	住い 住まい 棲まい
すまう	住う 住まう 棲まう
すまさ	済さ 済まさ 澄さ 澄まさ
すまし	清まし 済まし 澄し 澄まし
すます	済ます 澄す 澄ます
すまっ	住っ 住まっ
すまわ	住まわ 住わ 棲まわ
すみ	住み 棲み 清み 済み 澄み
すみかえ	住みかえ 住み替え 住替え
すみくらし	住み暮し 住み暮らし
すみこま	住みこま 住み込ま
すみこみ	住みこみ 住み込み
すみこむ	住みこむ 住み込む
すみこん	住みこん 住み込ん
すみつい	住みつい 住み付い 住み着い 棲みつい 棲み着い
すみつか	住みつか 住み着か
すみつき	住みつき 住み付き 住み着き 棲みつき 棲み着き
すみつく	住みつく 住み付く 住み着く 棲みつく 棲み着く
すみつこう	住みつこう 住み着こう
すみわけ	すみ分け 住み分け 棲み分け
すみわける	すみ分ける 住み分ける 棲み分ける
すむ	住む 栖む 棲む 済む 澄む
すめ	住め 棲め 清め 済め 澄め
すめる	住める 棲める
すも	住も 棲も 清も 澄も
すもう	住う 住もう
すら	スら 刷ら 掏ら 摩ら 摺ら 擂ら 擦ら 磨ら
すり	スり 刷り 掏り 摩り 摺り 擂り 擦り 磨り
すりあがっ	刷りあがっ 刷り上がっ 摺り上がっ
すりあがり	刷りあがり 刷り上がり
すりあがる	刷りあがる 刷り上がる
すりあげ	刷り上げ 磨りあげ 磨り上げ
すりあわさ	すり合わさ 摺り合わさ 擦り合わさ
すりあわせ	すり合せ すり合わせ 摺り合せ 摺り合わせ 擦りあわせ 擦り合せ 擦り合わせ
すりあわせる	すり合せる すり合わせる 摺り合わせる 擦りあわせる 擦り合わせる
すりおろさ	すり下ろさ 擦りおろさ
すりおろし	すり下ろし 摩り下ろし 擦りおろし 磨りおろし
すりおろす	すり下ろす 摩り下ろす 擦りおろす
すりかえ	すり変え すり替え 摩り替え 擦り替え
すりかえよう	すり替えよう 摩り替えよう
すりかえる	すり変える すり替える 摩り替える 擦り替える
すりかわっ	すり変わっ すり替わっ 摩り替わっ
すりかわら	すり替わら 摩り替わら
すりかわり	すり変わり すり替わり 摩り替わり
すりかわる	すり代る すり替わる 摩り替わる
すりきる	すり切る 摺り切る
すりきれ	すり切れ 擦り切れ 擦切れ
すりきれる	すり切れる 擦り切れる
すりこま	すり込ま 刷りこま 刷り込ま 擦り込ま
すりこみ	すり込み 刷りこみ 刷り込み 擦り込み
すりこむ	すり込む 刷りこむ 刷り込む 擦りこむ 擦り込む
すりこん	すり込ん 刷りこん 刷り込ん 擦り込ん
すりつけ	すり付け 摺付 擦り付け
すりつぶさ	すり潰さ 擂り潰さ 擦り潰さ 磨り潰さ
すりつぶし	すり潰し 擂りつぶし 擂り潰し 擦り潰し 磨りつぶし 磨り潰し
すりつぶす	すり潰す 擂りつぶす 擂り潰す 磨り潰す
すりとっ	すり取っ 掏り取っ
すりとら	すり取ら 掏り取ら
すりぬけ	すり抜け 擦り抜け
すりぬけよう	すり抜けよう 擦り抜けよう
すりぬける	すり抜ける 擦り抜ける
すりへっ	すり減っ 擦り減っ 磨り減っ
すりへら	すり減ら 擦り減ら
すりへらさ	すり減らさ 擦り減らさ 磨り減らさ
すりへらし	すり減らし 擦り減らし 磨り減らし
すりへり	すり減り 擦り減り 磨り減り
すりへる	すり減る 擦り減る 磨り減る
すりむい	擦りむい 擦り剥い
すりむく	擦りむく 擦り剥く
すりむけ	擦りむけ 擦り剥け
すりよせ	すり寄せ 摺り寄せ 擦り寄せ
すりよせる	すり寄せる 擦りよせる
すりよっ	すり寄っ 擦り寄っ
すりより	すり寄り 摺り寄り 擦り寄り
すりよる	すり寄る 擦り寄る
すりよろう	すり寄ろう 擦り寄ろう
する	スる 仕る 刷る 摩る 摺る 擂る 擦る 為る 磨る
すれ	スれ 刷れ 摩れ 摺れ 擦れ 為れ 磨れ
すれあい	すれ合い 擦れあい
すれあう	擦れあう 擦れ合う
すれちがい	すれ違い スレ違い 擦れ違い
すれちがう	すれ違う 擦れちがう 擦れ違う
すれちがえ	すれ違え 擦れ違え
すれちがえる	すれ違える 擦れ違える
すれちがっ	すれ違っ 擦れ違っ
すれる	スレる 擦れる 磨れる
すろう	スろう 掏ろう 擦ろう
すわっ	坐っ 座っ 座わっ 据わっ
すわら	坐ら 座ら 据わら
すわらさ	坐らさ 座らさ
すわり	坐り 座り 座わり 据わり
すわりこみ	すわり込み 座りこみ 座り込み
すわりこん	坐り込ん 座りこん 座り込ん
すわる	坐る 座る 座わる 据わる
すわれ	坐れ 座れ
すわれる	坐れる 座れる
すん	住ん 棲ん 清ん 済ん 澄ん
ずぬけ	ず抜け 図抜け 頭抜け
ずばぬけ	ずば抜け ズバ抜け
ずれおち	ずれ落ち ズレ落ち
ずれこみ	ずれ込み ズレ込み
ずれこん	ずれ込ん ズレ込ん
せ	仕 為
せい	仕い 塞い 急い
せいし	制し 征し 製し
せいしよう	制しよう 製しよう
せいする	制する 征する 製する
せいすれ	制すれ 製すれ
せいせ	制せ 製せ
せか	堰か 急か
せき	堰き 塞き 急き
せきあげ	せき上げ 堰き上げ
せきこま	咳込ま 急き込ま
せきこみ	せき込み 咳き込み 咳こみ 咳込み
せきこむ	せき込む 咳きこむ 咳き込む 咳込む 急き込む
せきこん	せき込ん 咳きこん 咳き込ん 咳込ん
せきたて	せき立て 急きたて 急き立て
せきとめ	せき止め 堰きとめ 堰き止め 堰止め 塞き止め
せきとめよう	せき止めよう 堰き止めよう
せきとめる	せき止める 堰き止める 堰止める 塞き止める
せく	堰く 塞く 急く
せっし	接し 摂し 節し
せっする	接する 摂する 節する
せっせ	接せ 摂せ
せっぱつまっ	せっぱ詰まっ 切羽つまっ 切羽詰っ 切羽詰まっ
せっぱつまり	切羽つまり 切羽詰まり
せばめ	狭ばめ 狭め
せまっ	迫っ 逼っ
せまら	迫まら 迫ら 逼ら
せまり	迫まり 迫り 逼り
せまりくる	迫りくる 迫り来る
せまる	迫まる 迫る 逼る
せまれ	迫まれ 迫れ
せめ	攻め 責め
せめあい	攻め合い 責め合い
せめあう	攻め合う 責め合う
せめあがっ	攻めあがっ 攻め上がっ
せめあがり	攻めあがり 攻め上がり
せめあがる	攻めあがる 攻め上がる
せめあぐみ	攻めあぐみ 攻め倦み
せめあっ	攻めあっ 攻め合っ 責め合っ
せめいっ	攻めいっ 攻め入っ 攻入っ
せめいり	攻めいり 攻め入り
せめいる	攻め入る 攻入る
せめいれ	攻めいれ 攻め入れ
せめおとさ	攻め落さ 攻め落とさ 攻め陥さ 攻落さ 攻落とさ
せめおとし	攻め落し 攻め落とし 攻め陥し 攻め陥とし 攻落し
せめおとす	攻め落す 攻め落とす 攻落す 責め落とす
せめおとそう	攻め落そう 攻め落とそう
せめかかっ	攻めかかっ 攻め掛かっ
せめかから	攻めかから 攻め掛から
せめかかり	攻めかかり 攻め掛かり
せめかかる	攻めかかる 攻め掛かる
せめかけ	攻めかけ 攻め懸け
せめぎあい	せめぎ合い 鬩ぎ合い
せめぎあう	せめぎ合う 鬩ぎ合う
せめぎあっ	せめぎ合っ 鬩ぎ合っ
せめくだる	攻めくだる 攻め下る
せめこま	攻めこま 攻め込ま
せめこみ	攻めこみ 攻め込み
せめこむ	攻めこむ 攻め込む
せめこもう	攻めこもう 攻め込もう
せめころさ	攻め殺さ 責め殺さ
せめころし	攻め殺し 責め殺し
せめころす	攻め殺す 責め殺す
せめこん	攻めこん 攻め込ん
せめさいなま	責めさいなま 責め苛ま
せめさいなみ	責めさいなみ 責め苛み
せめさいなむ	責めさいなむ 責め苛む
せめさいなん	責めさいなん 責め苛ん
せめたて	攻めたて 攻め立て 責めたて 責め立て
せめたてる	攻めたてる 攻め立てる 責めたてる 責め立てる
せめつぶす	攻めつぶす 攻め潰す
せめとがめ	責めとがめ 責め咎め
せめとっ	攻めとっ 攻め取っ 責め取っ
せめとり	攻めとり 攻め取り 責め取り
せめとる	攻めとる 攻め取る 責め取る
せめのぼっ	攻めのぼっ 攻め上っ 攻め登っ
せめのぼら	攻めのぼら 攻め上ら
せめのぼり	攻めのぼり 攻め上り
せめのぼる	攻めのぼる 攻め上る 攻め登る
せめほろぼし	攻め滅し 攻め滅ぼし
せめほろぼす	攻め滅す 攻め滅ぼす
せめよう	攻めよう 責めよう
せめよせ	攻めよせ 攻め寄せ
せめよせる	攻めよせる 攻め寄せる
せめる	攻める 責める
せめれ	攻めれ 責めれ
せめろ	攻めろ 責めろ
せめん	攻めん 責めん
せりあい	せり合い 競り合い
せりあう	せり合う 競り合う 競合う
せりあがっ	せり上がっ 競りあがっ 競り上がっ 迫り上がっ
せりあがり	せり上がり 競り上がり 迫り上がり
せりあがる	せり上がる 競りあがる 競り上がる 迫り上がる
せりあげ	せり上げ セリ上げ 競り上げ 迫り上げ
せりあげる	せり上げる 競り上げる 迫り上げる
せりあわ	競り合わ 競合わ
せりおとさ	競り落さ 競り落とさ 競落さ
せりおとし	せり落とし 競り落し 競り落とし 競落し
せりださ	せり出さ 迫り出さ
せりだし	せり出し 迫り出し 迫出し
せりだす	せり出す 迫り出す
せりで	せり出 迫り出
せんし	宣し 撰し 選し
せんじ	煎じ 詮じ
せんする	僭する 宣する 撰する 選する
せんせ	宣せ 撰せ
ぜり	競り 糶り
そい	削い 副い 殺い 沿い 添い
そいとげ	添いとげ 添い遂げ
そいとげる	添いとげる 添い遂げる
そう	副う 沿う 添う
そうし	奏し 相し 草し 葬し
そうする	奏する 草する 葬する
そうせ	奏せ 草せ
そえ	副え 沿え 添え 添へ
そえる	副える 沿える 添える 添へる
そおう	沿おう 添おう
そが	削が 殺が
そぎ	削ぎ 殺ぎ
そぎおとさ	そぎ落とさ 削ぎ落さ 削ぎ落とさ 殺ぎ落とさ
そぎおとし	そぎ落とし 削ぎ落し 削ぎ落とし
そぎおとす	そぎ落とす 削ぎ落す 削ぎ落とす
そぎおとそう	そぎ落とそう 削ぎ落そう 削ぎ落とそう
そぎとら	そぎ取ら 削ぎとら 削ぎ取ら
そぎとり	削ぎとり 削ぎ取り
そぎとる	そぎ取る 削ぎとる 削ぎ取る
そくさ	則さ 即さ
そくし	則し 即し
そくす	則す 即す
そくする	促する 則する 即する
そくせ	則せ 即せ
そぐ	削ぐ 殺ぐ
そげおち	そげ落ち 削げ落ち
そこない	損い 損ない
そこなう	害う 損う 損なう
そこなえ	損え 損なえ
そこなっ	損っ 損なっ
そこなわ	損なわ 損わ
そごう	削ごう 殺ごう
そしっ	誹っ 謗っ 譏っ
そしら	誹ら 謗ら 譏ら
そしり	毀り 誹り 謗り
そしる	誹る 謗る 譏る
そそい	注い 灌い
そそぎ	注ぎ 灌ぎ
そそぎいれ	注ぎいれ 注ぎ入れ
そそぎこま	注ぎこま 注ぎ込ま
そそぎこみ	そそぎ込み 注ぎこみ 注ぎ込み
そそぎこむ	そそぎ込む 注ぎこむ 注ぎ込む
そそぎこめ	注ぎこめ 注ぎ込め
そそぎこん	そそぎ込ん 注ぎこん 注ぎ込ん
そそぐ	注ぐ 灌ぐ 雪ぐ
そそげ	注げ 雪げ
そそのかさ	唆さ 唆のかさ
そだちあう	育ちあう 育ち合う
そだちゆく	育ちゆく 育ち行く
そだてあげ	育てあげ 育て上げ
そだてあげよう	育てあげよう 育て上げよう
そだてあげる	育てあげる 育て上げる
そだてなおし	育てなおし 育て直し
そだてなおす	育てなおす 育て直す
そっ	剃っ 副っ 反っ 沿っ 添っ
そっくりかえっ	そっくり返っ 反っくり返っ
そなえ	供え 備え 備へ 具え
そなえつけ	備えつけ 備え付け 備付け
そなえつける	備えつける 備え付ける
そなえもち	備え持ち 具え持ち
そなえもっ	そなえ持っ 備え持っ
そなえよ	供えよ 備えよ
そなえよう	供えよう 備えよう 備へよう
そなえる	供える 備える 具える
そなえれ	供えれ 備えれ
そなわっ	備っ 備わっ 具わっ
そなわら	備はら 備ら 備わら 具わら
そなわり	備はり 備わり 具わり
そなわる	備はる 備る 備わる 具わる
そなわれ	備はれ 備れ 備われ
そひ	副ひ 沿ひ
そびえたた	そびえ立た 聳え立た
そびえたち	そびえ建ち そびえ立ち 聳え立ち
そびえたっ	そびえ建っ そびえ立っ 聳えたっ 聳え立っ
そびえたつ	そびえ建つ そびえ立つ 聳え立つ
そふ	副ふ 沿ふ 添ふ
そまっ	染っ 染まっ
そまり	染まり 染り
そまる	染まる 染る
そむい	反い 叛い 背い
そむか	反か 叛か 背か
そむき	反き 叛き 背き
そむく	反く 叛く 背く
そむけ	反け 叛け 背け
そむこう	叛こう 背こう
そめ	初め 染め
そめあげ	染めあげ 染め上げ
そめあげる	染めあげる 染め上げる
そめかえ	染め変え 染め替え
そめだし	染め出し 染出し
そめぬい	染めぬい 染め抜い
そら	剃ら 反ら
そらさ	反らさ 外らさ 逸さ 逸らさ
そらし	反らし 外らし 逸らし
そらす	反らす 逸す 逸らす
そらせ	逸せ 逸らせ
そらそう	逸そう 逸らそう
そらんじ	誦んじ 諳じ 諳んじ
そらんずる	誦ずる 諳んずる
そり	剃り 反り
そりあげ	剃りあげ 剃り上げ
そりあげる	剃りあげる 剃り上げる
そりおとさ	そり落とさ 剃り落さ 剃り落とさ
そりおとし	そり落とし 剃りおとし 剃り落し 剃り落とし
そりおとす	そり落とす 剃り落す 剃り落とす
そりかえっ	そり返っ 反りかえっ 反り返っ
そりかえら	そり返ら 反りかえら 反り返ら
そりかえり	そり返り 反りかえり 反り返り
そりかえる	そり返る 反りかえる 反り返る
そる	剃る 反る
それ	剃れ 反れ 逸れ
それる	剃れる 反れる 逸れる
そろう	剃ろう 反ろう 揃う
そろえ	揃え 揃へ
そわ	副わ 沿わ 添わ
そんし	存し 損し
そんする	存する 損する
ぞくし	属し 屬し
ぞくする	属する 屬する
ぞくせ	属せ 屬せ
たい	炊い 焚い
たいし	体し 対し 對し 帯し 退し
たいする	体する 対する 對する 帯する 退する
たいせ	体せ 対せ 帯せ 退せ
たいらげ	平げ 平らげ
たいらげる	平げる 平らげる
たえ	堪え 絶え 絶へ 耐え 耐へ
たえしのば	堪え忍ば 耐え忍ば
たえしのび	堪え忍び 耐え忍び
たえしのぶ	堪え忍ぶ 耐えしのぶ 耐え忍ぶ
たえしのん	堪え忍ん 耐え忍ん
たえよ	堪えよ 絶えよ 耐えよ
たえよう	堪えよう 絶えよう 耐えよう
たえる	堪える 絶える 耐える
たえれ	堪えれ 絶えれ 耐えれ
たおさ	倒さ 斃さ
たおし	倒し 斃し
たおす	倒す 斃す 殪す
たおせる	倒せる 斃せる
たおそう	倒そう 斃そう
たおみ	撓み 攢
たおむ	撓 攢
たおめ	撓め 攢め
たおれ	仆れ 倒れ 手折れ 斃れ
たおれこま	倒れこま 倒れ込ま
たおれこみ	倒れこみ 倒れ込み
たおれこむ	倒れこむ 倒れ込む
たおれこん	倒れこん 倒れ込ん
たおれふし	倒れふし 倒れ伏し 倒れ臥し
たおれふす	倒れ伏す 倒れ臥す
たおれる	倒れる 斃れる
たか	炊か 焚か
たかなる	高なる 高鳴る
たかぶっ	昂っ 昂ぶっ 高ぶっ
たかぶら	昂ぶら 昂ら 高ぶら
たかぶり	昂ぶり 昂り 高ぶり
たかぶる	昂ぶる 昂る 高ぶる
たかまっ	昂まっ 高まっ
たかまり	昂まり 高まり
たかまる	昂まる 高まる
たかめ	昂め 高め
たかめあい	高めあい 高め合い
たかめあう	高めあう 高め合う
たかめあっ	高めあっ 高め合っ
たから	聚ら 集ら
たき	炊き 炷き 焚き
たきあがっ	炊きあがっ 炊き上がっ
たきあがり	炊きあがり 炊き上がり
たきあがる	炊きあがる 炊き上がる
たきあげ	炊きあげ 炊き上げ 焚き上げ
たきあげる	炊きあげる 炊き上げる 焚き上げる
たきこむ	炊き込む 焚き込む
たきこめ	炊き込め 焚き込め
たきしめ	焚きしめ 焚き染め
たきつけ	たき付け 焚きつけ 焚き付け
たきつける	たき付ける 焚きつける 焚き付ける
たぎる	沸る 滾る
たく	炊く 焚く
たくさ	托さ 託さ
たくし	托し 託し
たくす	托す 託す
たくする	托する 託する
たくそう	托そう 託そう
たくま	工ま 巧ま
たくみ	工み 巧み
たくわえ	蓄え 蓄わえ 貯え
たくわえよう	蓄えよう 貯えよう
たくわえる	蓄える 貯える
たくわえれ	蓄えれ 貯えれ
たぐりよせ	たぐり寄せ 手繰り寄せ
たぐりよせる	たぐり寄せる 手繰りよせる 手繰り寄せる
たけ	炊け 焚け 長け
たけりくるう	たけり狂う 猛り狂う
たけりくるっ	たけり狂っ 猛り狂っ
たける	哮る 炊ける 焚ける 猛る 長ける
たこう	炊こう 焚こう
たしあわせ	たし合わせ 足しあわせ 足し合わせ
たしあわせる	足しあわせる 足し合わせる
たしかめ	確かめ 確め
たしかめあい	確かめあい 確かめ合い
たしかめあう	確かめあう 確かめ合う
たしかめあおう	確かめあおう 確かめ合おう
たしかめあっ	確かめあっ 確かめ合っ
たしかめる	確かめる 確める
たしなめ	嗜め 窘め
たしなめる	嗜める 窘める
たす	足す ＋
たすけ	助け 助ケ 扶け 援け 援助 救け 輔け
たすけあい	助けあい 助け合い
たすけあう	助けあう 助け合う
たすけあっ	助けあっ 助け合っ
たすけよ	助けよ 輔けよ
たすけよう	助けよう 援けよう 救けよう
たすける	助ける 扶ける 援ける 救ける 輔ける
たずさえ	携え 携へ
たずさわっ	携っ 携わっ
たずさわら	携ら 携わら
たずさわり	携り 携わり
たずさわる	携る 携わる
たずさわれ	携れ 携われ
たずね	尋ね 探ね 訊ね 訪ね
たずねあて	尋ね当て 訪ねあて 訪ね当て
たずねあてる	尋ねあてる 訪ね当てる
たずねあるい	尋ね歩い 訪ね歩い
たずねあるき	尋ね歩き 訪ねあるき 訪ね歩き
たずねあるく	たずね歩く 尋ね歩く 訪ねあるく 訪ね歩く
たずねかえし	たずね返し 尋ね返し
たずねよ	尋ねよ 訪ねよ
たずねよう	尋ねよう 訊ねよう 訪ねよう
たずねる	尋ねる 訊ねる 訪ねる
たずねれ	尋ねれ 訊ねれ 訪ねれ
たずねろ	尋ねろ 訪ねろ
たそがれ	黄昏 黄昏れ
たそがれる	黄昏る 黄昏れる
たた	勃た 建た 断た 発た 立た 経た 絶た 裁た 起た
たたい	叩い 敲い
たたえ	湛え 称え 讃え 讚え 賛え
たたえあい	称え合い 讃えあい
たたえあう	称え合う 讃えあう
たたえあっ	称え合っ 讃えあっ
たたえよ	称えよ 讃えよ
たたえよう	称えよう 讃えよう
たたえる	湛える 称える 讃える 讚える 賛える 頌える
たたか	叩か 敲か
たたかい	戦い 斗い 闘い
たたかいあう	戦いあう 戦い合う
たたかいあっ	戦いあっ 戦い合っ
たたかいとっ	戦いとっ 戦い取っ 闘い取っ
たたかいとる	戦い取る 闘い取る
たたかう	戦う 斗う 闘う
たたかえ	戦え 斗え 闘え
たたかえる	戦える 闘える
たたかおう	戦おう 闘おう
たたかっ	戦っ 斗っ 闘っ
たたかふ	闘ふ 鬪ふ
たたかわ	戦わ 闘わ
たたかわさ	戦わさ 闘わさ
たたかわし	戦わし 闘わし
たたかわす	戦わす 闘わす
たたかわせ	戦わせ 闘わせ
たたき	タタき 叩き 敲き
たたきあい	たたき合い 叩きあい 叩き合い
たたきあう	たたき合う 叩きあう 叩き合う
たたきあげ	たたき上げ 叩きあげ 叩き上げ
たたきあげる	たたき上げる 叩き上げる
たたきあっ	たたき合っ 叩きあっ 叩き合っ
たたきあわ	たたき合わ 叩き合わ
たたきうり	たたき売り 叩き売り
たたきおこさ	たたき起こさ 叩き起こさ 叩き起さ
たたきおこし	たたき起こし 叩き起こし 叩き起し
たたきおこす	たたき起こす 叩き起こす
たたきおこそう	たたき起こそう 叩き起こそう
たたきおっ	たたき折っ 叩き折っ
たたきおとさ	たたき落さ たたき落とさ 叩き落さ 叩き落とさ
たたきおとし	たたき落とし 叩き落し 叩き落とし
たたきおとす	たたき落とす 叩き落す 叩き落とす
たたきおとそう	叩き落そう 叩き落とそう
たたきかえし	たたき返し 叩き返し
たたきかえす	たたき返す 叩き返す
たたききっ	たたき切っ 叩き切っ 叩き斬っ
たたききら	たたき切ら 叩き切ら 叩き斬ら
たたききり	たたき切り 叩き切り 叩き斬り
たたききる	たたき切る 叩き切る 叩き斬る
たたきこま	たたき込ま 叩きこま 叩き込ま
たたきこみ	たたき込み 叩きこみ 叩き込み
たたきこむ	たたき込む 叩きこむ 叩き込む
たたきこめ	たたき込め 叩き込め
たたきころさ	たたき殺さ 叩き殺さ
たたきころし	たたき殺し 叩き殺し
たたきころせ	たたき殺せ 叩き殺せ
たたきこわさ	たたき壊さ 叩き壊さ
たたきこわし	たたき壊し 叩きこわし 叩き壊し
たたきこわす	たたき壊す 叩き壊す
たたきこわそう	たたき壊そう 叩き壊そう
たたきこん	たたき込ん 叩きこん 叩き込ん
たたきださ	たたき出さ 叩き出さ
たたきだし	たたき出し 叩き出し
たたきだす	たたき出す 叩き出す
たたきだせ	たたき出せ 叩き出せ
たたきだせる	たたき出せる 叩き出せる
たたきだそう	たたき出そう 叩き出そう
たたきつけ	たたき付け 叩きつけ 叩き付け
たたきつけよう	叩きつけよう 叩き付けよう
たたきつける	たたき付ける 叩きつける 叩き付ける
たたきつぶさ	叩きつぶさ 叩き潰さ
たたきつぶし	たたき潰し 叩きつぶし 叩き潰し
たたきつぶす	叩きつぶす 叩き潰す
たたきつぶせ	叩きつぶせ 叩き潰せ
たたきつぶそう	叩きつぶそう 叩き潰そう
たたきなおし	たたき直し 叩きなおし 叩き直し
たたきなおす	たたき直す 叩きなおす 叩き直す
たたきのばし	たたき伸ばし 叩き伸ばし 叩き延ばし
たたきふせる	たたき伏せる 叩き伏せる
たたきわっ	たたき割っ 叩き割っ
たたきわら	たたき割ら 叩き割ら
たたきわり	たたき割り 叩き割り
たたきわる	たたき割る 叩き割る
たたく	叩く 敲く
たたけ	タタけ 叩け 敲け
たたし	立たし 起たし
たたみかけ	たたみ掛け 畳みかけ 畳み掛け
たたみかける	たたみ掛ける 畳みかける 畳み掛ける
たたみこま	たたみ込ま 畳み込ま
たたみこむ	たたみ込む 畳み込む
たたみこん	たたみ込ん 畳み込ん
たださ	正さ 糺さ 糾さ 質さ
ただし	正し 糺し 糾し 質し
ただす	正す 糺す 糾す 訊す 質す
ただせ	正せ 糺せ 糾せ 質せ
ただそう	正そう 糺そう 質そう
ただよい	漂い 漂よい
ただよわ	漂よわ 漂わ
たち	佇ち 勃ち 建ち 断ち 斷ち 発ち 立ち 経ち 絶ち 裁ち 起ち
たちあい	立ち会い 立ち合い 立会い 立合い
たちあう	立ちあう 立ち会う 立ち合う 立会う 立合う
たちあえ	立ち会え 立会え 立合え
たちあおう	立ち会おう 立ち合おう
たちあがっ	たち上がっ 建ち上がっ 立ちあがっ 立ち上がっ 立上がっ 起ちあがっ 起ち上がっ 起ち上っ
たちあがら	立ちあがら 立ち上がら 起ち上がら
たちあがり	立ちあがり 立ち上がり 立上がり 起ちあがり 起ち上がり 起ち上り
たちあがる	たち上がる たち上る 立ちあがる 立ち上がる 立上がる 起ち上がる 起ち上る
たちあがれ	勃ち上がれ 立ちあがれ 立ち上がれ 起ちあがれ 起ち上がれ
たちあがろう	立ちあがろう 立ち上がろう
たちあげ	立ちあげ 立ち上げ 立上げ
たちあげよう	立ちあげよう 立ち上げよう
たちあげる	立ちあげる 立ち上げる 立上げる
たちあっ	立ちあっ 立ち会っ 立ち合っ 立会っ 立合っ
たちあらわれ	たち現れ 立ちあらわれ 立ち現れ 立ち現われ
たちあらわれる	立ちあらわれる 立ち現れる 立ち現われる
たちあわ	立ちあわ 立ち会わ 立ち合わ 立会わ 立合わ
たちいたっ	立ちいたっ 立ち到っ 立ち至っ
たちいっ	立ちいっ 立ち入っ 立ち行っ 立入っ
たちいら	立ち入ら 立入ら
たちいり	立ち入り 立入り
たちいる	立ちいる 立ち入る 立入る
たちいれ	立ち入れ 立入れ
たちいれる	立ち入れる 立入れる
たちいろう	立ち入ろう 立入ろう
たちおとさ	断ち落とさ 裁ち落とさ
たちおとし	断ち落とし 裁ち落とし
たちかえっ	立ちかえっ 立ち帰っ 立ち返っ 立ち還っ
たちかえら	立ち帰ら 立ち返ら
たちかえり	立ちかえり 立ち帰り 立ち返り 立ち還り 立帰り 立返り
たちかえる	たち返る 立ちかえる 立ち帰る 立ち返る 立ち還る
たちかえれ	立ち帰れ 立ち返れ
たちかえろう	立ち帰ろう 立ち返ろう
たちかけ	立ちかけ 立ち掛け
たちかわっ	立ち代わっ 立ち替わっ
たちかわり	立ち代り 立ち代わり
たちきっ	たち切っ 断ち切っ 裁ち切っ
たちきら	たち切ら 断ち切ら
たちきり	たち切り 断ち切り 裁ち切り
たちきる	たち切る 断ち切る 断切る
たちきろう	断ち切ろう 裁ち切ろう
たちこみ	立ちこみ 立ち込み
たちこめ	立ちこめ 立ち籠め 立ち込め 立込め
たちこめる	たち込める 立ちこめる 立ち籠める 立ち込める
たちさがり	立ち下がり 立下り
たちさっ	立ち去っ 立去っ
たちさら	立ちさら 立ち去ら
たちすくみ	立ちすくみ 立ち竦み
たちすくむ	立ちすくむ 立ち竦む
たちすくん	立ちすくん 立ち竦ん
たちそびえ	立ちそびえ 立ち聳え
たちつくし	立ちつくし 立ち尽くし
たちつくす	立ちつくす 立ち尽くす
たちどまっ	立ち停まっ 立ち止っ 立ち止まっ 立止まっ
たちどまら	立ちどまら 立ち止まら
たちどまり	立ち止まり 立ち止り
たちどまる	立ちどまる 立ち止まる 立ち留まる
たちなおっ	立ちなおっ 立ち直っ 立直っ
たちなおり	立ちなおり 立ち直り 立直り
たちなおる	たち直る 立ちなおる 立ち直る 立直る
たちならび	たち並び 建ちならび 建ち並び 立ちならび 立ち並び
たちならぶ	建ちならぶ 建ち並ぶ 立ちならぶ 立ち並ぶ
たちならべ	建ち並べ 立ち並べ 立並べ
たちならん	たち並ん 建ち並ん 立ちならん 立ち並ん 立並ん
たちのい	立ち退い 立退い
たちのか	立ち退か 立退か
たちのき	立ち退き 立退き
たちのく	立ちのく 立ち退く 立退く
たちのぼっ	立ちのぼっ 立ち上っ 立ち昇っ 立のぼっ 立上っ
たちのぼら	立ち上ら 立ち昇ら
たちのぼり	立ちのぼり 立ち上り 立ち昇り 立上り
たちのぼる	立ちのぼる 立ち上る 立ち昇る 立ち登る 立のぼる 立上る
たちはたらく	立ち働く 立働く
たちふさがっ	立ちふさがっ 立ち塞がっ
たちふさがり	立ちふさがり 立ち塞がり
たちふさがる	立ちふさがる 立ち塞がる
たちまさっ	立ちまさっ 立ち勝っ
たちまわっ	立ちまわっ 立ち回っ
たちまわり	立ちまわり 立ち回り 立回り 立廻り
たちむかい	たち向い 立ち向い 立ち向かい 立向い
たちむかう	立ちむかう 立ち向う 立ち向かう 立向かう
たちむかえ	立ち向え 立ち向かえ
たちむかえる	立ち向える 立ち向かえる
たちむかおう	立ち向おう 立ち向かおう
たちむかっ	立ち向かっ 立ち向っ
たちむかわ	立ち向かわ 立ち向わ
たちもどっ	立ち戻っ 立戻っ
たちもどり	立ちもどり 立ち戻り 立戻り
たちゆか	立ちゆか 立ち行か
たちゆく	立ちゆく 立ち行く
たちよっ	たち寄っ 立ちよっ 立ち寄っ
たちより	立ちより 立ち寄り
たちよる	立ちよる 立ち寄る
たちよれ	立ちよれ 立ち寄れ
たちわっ	たち割っ 断ち割っ
たっ	勃っ 建っ 断っ 発っ 立っ 経っ 絶っ 裁っ 起っ 足っ
たっとび	尊び 貴び
たつ	佇つ 建つ 截つ 断つ 発つ 立つ 経つ 絶つ 裁つ 起つ
たて	建て 断て 樹て 点て 発て 立 立て 経て 絶て 起て 閉て
たてあい	立てあい 立て合い
たてかえ	建てかえ 建て替え 建替え 立て替え 立替え
たてかえよう	建て替えよう 立て替えよう
たてかえる	建てかえる 建て替える 建替える 立て替える 立替える
たてかけ	立てかけ 立て掛け
たてかける	立てかける 立て掛ける
たてこま	建てこま 建て込ま 立て込ま
たてこみ	建てこみ 建て混み 建て込み 建込み 立て込み
たてこむ	建て込む 立て込む
たてこもっ	立てこもっ 立て篭っ 立て篭もっ 立て籠っ 立て籠もっ 立籠っ
たてこもら	立てこもら 立て篭もら 立て籠もら
たてこもり	立てこもり 立て篭もり 立て篭り 立て籠もり 立て籠り
たてこもる	立てこもる 立て篭もる 立て篭る 立て籠もる 立て籠る 立籠もる 立籠る
たてこもろう	立てこもろう 立て籠もろう 立て籠ろう
たてこん	建て込ん 立て込ん
たてつい	楯突い 盾突い
たてつき	楯突き 盾突き
たてつく	たて突く 楯つく 楯突く 盾突く
たてつらね	建て連ね 立て連ね
たてとおし	立て通し 立通し
たてなおさ	建てなおさ 建て直さ 建直さ 立てなおさ 立て直さ
たてなおし	たて直し 建てなおし 建て直し 建直し 立てなおし 立て直し
たてなおす	たて直す 建てなおす 建て直す 立てなおす 立て直す
たてなおせ	たて直せ 建て直せ 立て直せ
たてなおせる	建て直せる 立て直せる
たてなおそう	建てなおそう 建て直そう 立てなおそう 立て直そう
たてならべ	建て並べ 立て並べ
たてまわし	立て回し 立て廻し
たてまわす	立て回す 立て廻す
たてよ	建てよ 断てよ 立てよ 起てよ
たてよう	建てよう 立てよう
たてる	建てる 樹てる 点てる 立てる 立る 絶てる
たてれ	建てれ 立てれ
たてろ	建てろ 立てろ 起てろ
たてん	建てん 立てん
たと	建と 断と 発と 立と 経と 絶と 經と
たとう	断とう 発とう 立とう 経とう 絶とう 起とう
たとえ	例え 喩え 譬え
たとえよう	例えよう 喩えよう
たとえる	例える 喩える 譬える
たとえれ	例えれ 喩えれ 譬えれ
たどりつい	たどり着い 辿りつい 辿り付い 辿り着い
たどりつか	たどり着か 辿りつか 辿り付か 辿り着か
たどりつき	たどり着き 辿りつき 辿り付き 辿り着き
たどりつく	たどり着く 辿りつく 辿り付く 辿り着く
たどりつけ	たどり着け 辿りつけ 辿り着け
たどりつける	たどり着ける 辿りつける 辿り着ける
たどりつけれ	たどり着けれ 辿り着けれ
たどりつこう	たどり着こう 辿りつこう 辿り付こう 辿り着こう
たのしま	娯しま 愉しま 楽しま
たのしみ	娯しみ 愉しみ 楽しみ
たのしむ	愉しむ 楽しむ
たのしめ	愉しめ 楽しめ 楽め
たのしめる	愉しめる 楽しめる 楽める
たのしん	愉しん 楽しん
たのみ	恃み 頼み
たのみこま	頼みこま 頼み込ま
たのみこみ	頼みこみ 頼み込み
たのみこむ	頼みこむ 頼み込む
たのみこん	頼みこん 頼み込ん
たのむ	恃む 頼む
たのん	恃ん 頼ん
たびかさなっ	たび重なっ 度重なっ
たびかさなり	たび重なり 度重なり
たびかさなる	たび重なる 度かさなる 度重なる
たびだち	旅だち 旅立ち
たびだっ	旅だっ 旅立っ
たびだつ	旅だつ 旅立つ
たべ	喰べ 給べ 食べ
たべあい	食べあい 食べ合い
たべあう	食べあう 食べ合う
たべくらべ	食べくらべ 食べ比べ
たべよ	給べよ 食べよ
たべる	喰べる 食べる
たまい	給い 賜い
たまう	給う 賜う
たまえ	給え 賜え
たまっ	堪っ 溜っ 溜まっ 給っ 貯っ 貯まっ 賜っ
たまら	堪ら 溜まら 溜ら 貯まら
たまり	堪り 溜まり 溜り 貯まり
たまる	溜まる 貯まる
たまれ	溜まれ 溜れ 貯まれ
たまわ	給わ 賜わ
たまわっ	給わっ 賜っ 賜わっ
たまわら	給わら 賜ら 賜わら
たまわり	給わり 賜り 賜わり
たまわる	給わる 賜る 賜わる
たまわれ	給われ 賜れ 賜われ
たまわれる	給われる 賜れる
たまわん	給わん 賜わん
ため	溜め 矯め 蓄め 貯め
ためこま	ため込ま 溜めこま 溜め込ま 貯め込ま
ためこみ	ため込み 溜めこみ 溜め込み 貯め込み
ためこむ	ため込む 溜めこむ 溜め込む 貯め込む
ためこめる	ため込める 溜め込める
ためこもう	ため込もう 溜め込もう
ためこん	ため込ん 溜めこん 溜め込ん 貯め込ん
ためさ	試さ 試めさ 験さ
ためし	試し 験し
ためす	試す 験す
ためそう	試そう 試めそう
ためよう	矯めよう 貯めよう
ためる	タメる 溜める 矯める 貯める
ためれ	溜めれ 貯めれ
ためろ	溜めろ 貯めろ
たもう	給う 賜う
たもふ	給ふ 賜ふ
たより	便り 頼り
たよる	便る 頼る
たらし	垂し 垂らし 誑し
たらしこん	たらし込ん 誑しこん
たらす	垂らす 滴らす 誑す
たれ	垂れ 滴れ 足れ
たれこみ	たれ込み タレ込み 垂れ込み
たれこむ	たれ込む タレ込む 垂れ込む
たれこめ	たれ込め 垂れこめ 垂れ込め
たれこめる	たれ込める 垂れこめる 垂れ込める
たれこん	たれ込ん 垂れ込ん
たれさがっ	垂れさがっ 垂れ下がっ 垂れ下っ
たれさがり	垂れさがり 垂れ下がり 垂れ下り
たれさがる	たれ下がる 垂れさがる 垂れ下がる
たれさげ	たれ下げ 垂れ下げ
たれながさ	たれ流さ 垂れ流さ
たれながし	たれ流し 垂れ流し
たれながれ	たれ流れ 垂れ流れ
たれる	タレる 垂れる
たんじ	嘆じ 歎じ
たんずる	嘆ずる 歎ずる
だきあい	抱きあい 抱き合い
だきあう	抱きあう 抱き合う
だきあげ	抱きあげ 抱き上げ
だきあげる	抱きあげる 抱き上げる
だきあっ	抱きあっ 抱き合っ
だきあわせ	抱き合せ 抱き合わせ
だきおこさ	抱き起こさ 抱き起さ
だきおこし	抱き起こし 抱き起し
だきかかえ	抱きかかえ 抱き抱え
だきかかえる	抱きかかえる 抱き抱える
だきこま	抱きこま 抱き込ま
だきこみ	抱きこみ 抱き込み 抱込み
だきこむ	抱きこむ 抱き込む 抱込む
だきこもう	抱きこもう 抱き込もう
だきこん	抱きこん 抱き込ん
だきしめ	抱きしめ 抱き締め
だきしめよう	抱きしめよう 抱き締めよう
だきしめる	抱きしめる 抱き締める
だきつい	抱きつい 抱き付い 抱き着い
だきつか	抱きつか 抱き付か 抱き着か
だきつき	抱きつき 抱き付き 抱き着き
だきつく	抱きつく 抱き付く 抱き着く
だきつこう	抱きつこう 抱き付こう 抱き着こう
だきとめ	抱きとめ 抱き止め 抱き留め
だきとめる	抱きとめる 抱き止める 抱き留める
だきよせ	抱きよせ 抱き寄せ
だきよせる	抱きよせる 抱き寄せる
ださ	出さ 堕さ
だし	出し 堕し
だしあい	出しあい 出し合い
だしあう	出しあう 出し合う
だしあっ	出しあっ 出し合っ
だしかけ	出しかけ 出し掛け
だししぶり	出ししぶり 出し渋り
だししぶる	出ししぶる 出し渋る
だしぬい	出しぬい 出し抜い
だしぬか	出しぬか 出し抜か
だせ	出せ 堕せ
だべる	ダべる 駄弁る
だまさ	ダマさ 欺さ 瞞さ 騙さ
だまし	ダマし 欺し 瞞し 騙し
だましとっ	だまし取っ 騙しとっ 騙し取っ
だましとら	だまし取ら ダマし取ら 騙し取ら 騙し盗ら
だましとり	だまし取り 騙しとり 騙し取り 騙し盗り
だましとる	だまし取る 騙しとる 騙し取る 騙し盗る
だましとろう	だまし取ろう 騙しとろう 騙し取ろう
だます	ダマす 欺す 瞞す 騙す
だませ	ダマせ 騙せ
だまそう	ダマそう 欺そう 騙そう
だまりこみ	黙りこみ 黙り込み
だまりこむ	黙りこむ 黙り込む
だまりこん	黙りこん 黙り込ん
だんじ	弾じ 断じ 談じ
だんじる	弾じる 断じる 談じる
だんずる	断ずる 談ずる
だんずれ	断ずれ 談ずれ
だんぜ	断ぜ 談ぜ
ちかいあい	誓いあい 誓い合い
ちかいあう	誓いあう 誓い合う
ちかいあっ	誓いあっ 誓い合っ
ちかづい	近い 近づい 近付い
ちかづか	近か 近づか 近付か
ちかづき	近き 近づき 近付き 近附き
ちかづく	近づく 近付く
ちかづけ	近づけ 近付け
ちかづけよう	近づけよう 近付けよう
ちかづける	近づける 近付ける
ちかづこう	近づこう 近付こう
ちかよっ	近よっ 近寄っ
ちかよら	近よら 近寄ら
ちかより	近より 近寄り
ちからづけ	力づけ 力付け
ちからづける	力づける 力付ける
ちがっ	異っ 違っ
ちぎっ	千切っ 契っ
ちぎら	千切ら 契ら
ちぎり	千切り 契り
ちぎる	千切る 契る
ちぢみあがっ	縮みあがっ 縮み上がっ
ちぢみあがり	縮み上がり 縮み上り
ちぢめる	ちゞめる 縮める
ちゃくし	着し 著し
ちゃくしよう	着しよう 著しよう
ちゃくする	着する 著する
ちゅうさ	沖さ 註さ
ちゅうし	冲し 沖し 注し 註し 誅し
ちゅうする	注する 註する 誅する
ちゅうすれ	注すれ 誅すれ
ちょうし	寵し 弔し 徴し 朝し 諜し
ちょうする	徴する 朝する
ちょんぎる	ちょん切る チョン切る
ちらつく	チラつく 散らつく
ちりばめ	散りばめ 鏤め
ちりばめる	散りばめる 鏤める
つい	ツい 亜い 付い 即い 嗣い 就い 従い 憑い 接い 搗い 撞い 次い 注い 点い 着い 突い 継い 著い 衝い 附い 随い
ついえ	潰え 費え
ついえる	潰える 費える
ついやさ	費さ 費やさ
ついやし	費し 費やし
ついやす	費す 費やす
つうじあう	通じあう 通じ合う
つうじあえる	通じあえる 通じ合える
つうじあっ	通じあっ 通じ合っ
つうじあわ	通じあわ 通じ合わ
つか	付か 即か 就か 憑か 搗か 撞か 活か 点か 着か 突か 著か 衝か 附か 随か
つかい	使い 遣い
つかいこま	使いこま 使い込ま
つかいこみ	使い込み 遣い込み
つかいこん	使いこん 使い込ん 遣い込ん
つかいふるし	使いふるし 使い古し
つかいまわさ	使いまわさ 使い回さ
つかいまわし	使いまわし 使い回し
つかいまわす	使いまわす 使い回す
つかいまわせ	使いまわせ 使い回せ
つかいまわせる	使いまわせる 使い回せる
つかいわけ	使いわけ 使い分け
つかいわける	使いわける 使い分ける
つかう	使う 遣う
つかえ	事え 事へ 仕え 使え 遣え 閊え
つかえる	事える 事へる 仕える 使える 遣える
つかえれ	仕えれ 使えれ
つかえん	事えん 仕えん 使えん
つかおう	使おう 遣おう
つかさ	付かさ 就かさ
つかさどっ	司っ 司どっ 掌っ
つかさどら	主ら 司どら 司ら 掌ら
つかさどり	主り 司どり 司り 掌り
つかさどる	主る 司どる 司る 掌る
つかさどれ	主れ 司れ 掌れ
つかさどろう	司ろう 掌ろう
つかし	付かし 就かし
つかせ	付かせ 就かせ
つかっ	使っ 浸かっ 漬かっ 遣っ
つかま	把ま 捕ま 掴ま 摑ま
つかまえ	捉まえ 捕まえ 掴まえ 摑まえ
つかまえよう	捕まえよう 掴まえよう
つかまえる	捉まえる 捕まえる 掴まえる
つかまえれ	捕まえれ 掴まえれ
つかまさ	掴まさ 摑まさ
つかまっ	捉まっ 捕まっ 掴まっ 摑まっ
つかまら	捕まら 掴まら
つかまり	捉まり 捕まり 掴まり 摑まり
つかまる	捉まる 捕まる 掴まる 摑まる
つかまれ	捉まれ 捕まれ 掴まれ 摑まれ
つかみ	掴み 摑み 攫み
つかみあい	つかみ合い 掴みあい 掴み合い
つかみあう	つかみ合う 掴み合う
つかみあげ	つかみ上げ 掴み上げ
つかみあっ	つかみ合っ 掴みあっ 掴み合っ
つかみかえし	つかみ返し 掴み返し
つかみかかっ	つかみ掛かっ 掴みかかっ 掴み掛かっ 摑みかかっ
つかみかから	掴みかから 摑みかから
つかみかかる	つかみ掛かる 掴みかかる 掴み掛かる
つかみかかろう	掴みかかろう 掴み掛かろう
つかみころし	つかみ殺し 掴み殺し
つかみだし	つかみ出し 掴み出し
つかみだす	つかみ出す 掴み出す
つかみとっ	つかみ取っ 掴み取っ 摑み取っ
つかみとり	つかみ取り 掴み取り 摑み取り
つかみとる	つかみ取る 掴み取る
つかみとれ	つかみ取れ 掴み取れ
つかみとれる	つかみ取れる 掴み取れる
つかみとろう	つかみ取ろう 掴み取ろう
つかみなおす	つかみ直す 掴み直す
つかむ	掴む 摑む 攫む
つかめ	把め 掴め 摑め
つから	浸から 漬から
つかり	浸かり 漬かり
つかる	浸かる 漬かる 漬る
つかれ	浸かれ 漬かれ 疲れ
つかれる	浸かれる 疲れる
つかわ	使わ 遣わ
つかわさ	使わさ 遣さ 遣わさ
つかわし	使わし 遣し 遣わし
つかわす	使わす 遣す 遣わす
つかん	把ん 掴ん 摑ん 攫ん
つが	ツが 亜が 嗣が 接が 次が 注が 継が 繼が
つき	付き 即き 就き 尽 尽き 憑き 搗き 撞き 活き 点き 盡き 着き 突き 著き 衝き 附き
つきあい	つき合い 付きあい 付き合い 突きあい 突き合い
つきあう	つき合う 付きあう 付き合う 付合う 突き合う
つきあえ	つき合え 付き合え 突き合え
つきあおう	つき合おう 付き合おう
つきあがっ	つき上がっ 突き上がっ
つきあがり	つき上がり 突き上がり
つきあげ	突きあげ 突き上げ 衝き上げ
つきあたっ	つき当たっ 突きあたっ 突き当たっ 突き当っ
つきあたり	つき当たり 突きあたり 突き当たり 突き当り
つきあたる	つき当たる 突きあたる 突き当たる 突き当る
つきあっ	つき合っ 付きあっ 付き合っ 突きあっ 突き合っ
つきあわ	つき合わ 交際わ 付きあわ 付き合わ 付合わ 突きあわ 突き合わ
つきあわさ	つき合わさ 付き合わさ 突き合わさ
つきあわせ	つき合わせ 付き合わせ 突き合せ 突き合わせ
つきあわせる	つき合わせる 付き合わせる 搗き合わせる 突き合わせる
つきあわせれ	突き合せれ 突き合わせれ
つきいれ	つき入れ 突き入れ
つきうごかさ	つき動かさ 突き動かさ 衝き動かさ
つきうごかし	つき動かし 突き動かし 衝き動かし
つきうごかす	つき動かす 突き動かす 衝き動かす
つきおとさ	つき落とさ 突き落さ 突き落とさ
つきおとし	つき落とし 突き落し 突き落とし
つきおとす	つき落とす 突き落す 突き落とす
つきおとそう	つき落とそう 突き落そう 突き落とそう
つきかえさ	つき返さ 突き返さ
つきかえし	つき返し 突きかえし 突き返し
つきかえす	つき返す 突き返す
つきかため	つき固め 搗き固め 突き固め
つきかためる	つき固める 突き固める
つきくずさ	つき崩さ 突き崩さ
つきくだい	つき砕い 突き砕い
つきくだき	つき砕き 突き砕き
つきささ	突きささ 突き刺さ
つきささっ	つき刺さっ 突きささっ 突き刺さっ
つきさし	突きさし 突き刺し 突き差し 突刺し
つきさす	つき刺す 突きさす 突き刺す 突き差す 突刺す
つきさせ	突きさせ 突き刺せ
つきしたがい	つき従い 付き従い 付き随い
つきしたがう	つき従う 付きしたがう 付き従う 付き随う
つきしたがえ	つき従え 付き従え
つきしたがっ	つき従っ 付きしたがっ 付き従っ 付き随っ
つきしたがわ	つき従わ 付き従わ
つきすすみ	つき進み 突き進み
つきすすむ	つき進む 突き進む
つきそい	付き添い 付添い
つきそう	付きそう 付き添う 附き添う
つきそっ	つき添っ 付きそっ 付き添っ 付添っ
つきそわ	つき添わ 付き添わ 付添わ
つきたて	つき立て 突きたて 突き立 突き立て
つきたてよう	つき立てよう 突き立てよう
つきたてる	突きたてる 突き立てる
つきださ	付き出さ 突きださ 突き出さ
つきだし	つき出し 付き出し 突きだし 突き出し
つきだす	つき出す 突きだす 突き出す
つきだそう	つき出そう 付き出そう 突きだそう 突き出そう
つきつけ	突きつけ 突き付け 突付け
つきつけよう	突きつけよう 突き付けよう
つきつける	突きつける 突き付ける 突付ける
つきつめ	突きつめ 突き詰め
つきつめる	突きつめる 突き詰める
つきつめれ	突きつめれ 突き詰めれ
つきで	つき出 突きで 突き出
つきでる	つき出る 突き出る
つきとばし	突きとばし 突き飛ばし
つきとめ	つき止め 突きとめ 突き止め 突止め
つきとめよう	つき止めよう 突きとめよう 突き止めよう
つきとめる	つき止める 突きとめる 突き止める
つきぬけ	つき抜け 突きぬけ 突き抜け
つきぬける	つき抜ける 突きぬける 突き抜ける
つきはなさ	つき放さ 突き放さ 突き離さ
つきはなし	つき放し つき離し 突きはなし 突き放し 突き離し
つきはなす	突き放す 突き離す
つきまぜ	搗き混ぜ 突き混ぜ
つきまぜる	つき混ぜる 搗き混ぜる
つきまとい	付きまとい 付き纏い 附きまとい
つきまとう	付きまとう 付き纏う
つきまとっ	付きまとっ 付き纏っ
つきまとわ	付きまとわ 付き纏わ
つきまとわれ	付きまとわれ 付き纏われ
つきゃ	着きゃ 突きゃ
つきやぶっ	つき破っ 突き破っ
つきやぶり	つき破り 突き破り
つきやぶる	突きやぶる 突き破る
つきる	尽きる 尽る 盡きる
つぎ	ツぎ 嗣ぎ 接ぎ 次ぎ 注ぎ 継ぎ 繼ぎ
つぎあわせ	つぎ合わせ 接ぎ合わせ 継ぎあわせ 継ぎ合せ 継ぎ合わせ
つぎこめ	つぎ込め 注ぎ込め
つぎこめる	つぎ込める 注ぎ込める
つぎたさ	つぎ足さ 注ぎ足さ 継ぎ足さ
つぎたし	つぎ足し 注ぎ足し 継ぎ足し
つぎたす	つぎ足す 注ぎ足す 継ぎ足す
つく	付く 作 即く 就く 憑く 搗く 撞く 点く 着く 突く 粘く 著く 衝く 附く
つくさ	尽くさ 尽さ 盡くさ
つくし	尽くし 尽し 盡くし 盡し
つくす	尽くす 尽す 盡す
つくせ	尽くせ 尽せ 盡くせ 盡せ
つくせる	尽くせる 尽せる
つくそう	尽くそう 尽そう
つくっ	作っ 創っ 粧っ 製っ 造っ
つくら	作ら 創ら 製ら 造ら
つくらさ	作らさ 造らさ
つくらし	作らし 造らし
つくり	作り 創り 製り 造り
つくりあげ	つくり上げ 作りあげ 作り上げ 創りあげ 創り上げ 造りあげ 造り上げ
つくりあげよう	作りあげよう 作り上げよう 創り上げよう 造り上げよう
つくりあげる	つくり上げる 作りあげる 作り上げる 創りあげる 創り上げる 造りあげる 造り上げる
つくりあげん	作り上げん 創り上げん
つくりかえ	つくり変え つくり替え 作りかえ 作り変え 作り替え 造りかえ 造り変え 造り替え
つくりかえよう	作りかえよう 作り変えよう 作り替えよう
つくりかえる	つくり変える 作りかえる 作り変える 作り替える 造りかえる 造り変える 造り替える
つくりこま	つくり込ま 作りこま 作り込ま
つくりこみ	作りこみ 作り込み
つくりこむ	作りこむ 作り込む
つくりこもう	作りこもう 作り込もう
つくりこん	作りこん 作り込ん
つくりそだて	つくり育て 作り育て
つくりそだてる	つくり育てる 作り育てる 造り育てる
つくりため	作りため 作り溜め 作り貯め
つくりださ	つくり出さ 作りださ 作り出さ 創りださ 創り出さ 造りださ 造り出さ
つくりだし	つくり出し 作りだし 作り出し 創りだし 創り出し 造りだし 造り出し
つくりだす	つくり出す 作りだす 作り出す 創りだす 創り出す 造りだす 造り出す
つくりだせ	つくり出せ 作り出せ 創りだせ 創り出せ
つくりだせる	つくり出せる 作りだせる 作り出せる 創り出せる 造り出せる
つくりだせれ	つくり出せれ 作り出せれ
つくりだそう	つくり出そう 作りだそう 作り出そう 創りだそう 創り出そう 造りだそう 造り出そう
つくりなおさ	つくり直さ 作りなおさ 作り直さ 造り直さ
つくりなおし	つくり直し 作りなおし 作り直し 造り直し
つくりなおす	つくり直す 作りなおす 作り直す 造り直す
つくりなおせ	作り直せ 造り直せ
つくる	作る 創る 製る 造る
つくれ	作れ 創れ 造れ
つくれよ	作れよ 造れよ
つくれる	作れる 創れる 造れる
つくれれ	作れれ 創れれ
つくろう	作ろう 創ろう 繕う 造ろう
つぐ	ツぐ 亜ぐ 嗣ぐ 接ぐ 次ぐ 注ぐ 継ぐ 繼ぐ
つけ	了 付 付け 即け 就け 尾け 尾行 憑け 撞け 活け 浸け 漬け 点け 燗け 狙 着け 突け 著け 衝け 附 附け 點
つけあがっ	つけ上がっ 付け上がっ 漬けあがっ 漬け上がっ
つけあがり	つけ上がり 漬け上がり
つけあがる	漬けあがる 漬け上がる
つけいっ	つけ入っ 付け入っ
つけいら	つけ入ら 付け入ら 付入ら
つけいり	つけ入り 付け入り
つけいる	つけ入る 付け入る 付入る
つけいれ	つけ入れ 付け入れ
つけおき	浸け置き 漬け置き
つけおく	浸け置く 漬け置く
つけかえ	つけ変え つけ替え 付けかえ 付け替え
つけかえる	つけ替える 付けかえる 付け替える
つけかえれ	つけ替えれ 付け替えれ
つけくわえ	つけ加え 付けくわえ 付け加え 付加え 附け加え
つけくわえる	つけ加える 付けくわえる 付け加える
つけくわえれ	つけ加えれ 付け加えれ
つけくわわっ	つけ加わっ 付け加わっ
つけくわわる	つけ加わる 付け加わる
つけこま	つけ込ま 付けこま 付け込ま 漬けこま 漬け込ま
つけこみ	つけ込み 付けこみ 付け込み 浸け込み 漬けこみ 漬け込み
つけこむ	つけ込む 付けこむ 付け込む 漬けこむ 漬け込む
つけこめ	つけ込め 付け込め 漬け込め
つけこもう	つけ込もう 付けこもう 付け込もう
つけこん	つけ込ん 付け込ん 漬けこん 漬け込ん
つけたさ	つけ足さ 付け足さ
つけたし	つけ足し 付け足し
つけたす	つけ足す 付け足す
つけたせ	つけ足せ 付け足せ
つけなおし	つけ直し 付け直し
つけなおす	つけ直す 付け直す
つけねらい	つけ狙い 付け狙い
つけねらう	つけ狙う 付けねらう 付け狙う
つけねらっ	つけ狙っ 付けねらっ 付け狙っ
つけねらわ	つけ狙わ 付けねらわ 付け狙わ
つけまわさ	つけ回さ 付け回さ
つけまわし	つけ回し 付け回し 尾け回し
つけまわす	つけ回す つけ廻す 付け回す
つけよ	付けよ 点けよ
つけよう	付けよう 即けよう 就けよう 浸けよう 点けよう 着けよう
つける	ツケる 付ける 付る 即ける 就ける 尾ける 憑ける 撞ける 浸ける 漬ける 点ける 狙る 着ける 突ける 衝ける 附ける
つけれ	付けれ 就けれ 着けれ
つけろ	付けろ 点けろ 着けろ
つげ	告 告げ 嗣げ 接げ 次げ 継げ
つげる	告げる 告る 嗣げる 継げる
つげん	告げん 継げん
つこ	使 点こ 粘こ
つこう	付こう 即こう 就こう 撞こう 着こう 突こう 衝こう 附こう
つごう	ツごう 継ごう
つたえ	伝え 傳え
つたえあう	伝えあう 伝え合う
つたえあっ	伝えあっ 伝え合っ
つたえきい	伝えきい 伝え聞い
つたえる	伝える 傳える
つちかわ	培かわ 培わ
つっ	つッ 吊っ 攣っ 釣っ
つっかかっ	突っかかっ 突っ掛かっ
つっかかる	突っかかる 突っ掛かる
つっかけ	突っかけ 突っ掛け
つっかける	突っかける 突っ掛ける
つっこま	つっ込ま ツッこま ツッコま 突っこま 突っ込ま
つっこみ	ツッこみ ツッコみ 突っ込み
つっこむ	ツッこむ ツッコむ 突っこむ 突っ込む
つっこめ	ツッコめ 突っこめ 突っ込め
つっこめる	突っこめる 突っ込める
つっこもう	ツッコもう 突っ込もう
つっこん	つっ込ん ツッこん ツッコん 突っこん 突っ込ん
つったっ	つっ立っ 突っ立っ 突ッ立っ
つっつい	突っつい 突っ突い 突付い
つっつく	突っつく 突っ突く 突付く
つっぱしっ	突っぱしっ 突っ走っ
つっぱしる	つっ走る 突っ走る
つっぱしれ	つっ走れ 突っ走れ
つっぱっ	ツッパっ 突っ張っ
つっぱね	突っぱね 突っ撥ね
つっぱねる	突っぱねる 突っ撥ねる
つっぱる	ツッパる 突っぱる 突っ張る 突張る
つっぷし	突っ伏し 突伏し
つつしま	慎しま 慎ま 謹ま
つつしみ	慎み 謹み
つつしむ	慎しむ 慎む 謹む
つつしめ	慎め 謹め
つつしん	慎ん 謹ん
つつみ	つゝみ 包み
つつみこま	包みこま 包み込ま
つつみこみ	包みこみ 包み込み
つつみこむ	包みこむ 包み込む
つつみこん	包みこん 包み込ん
つつむ	つゝむ 包む
つづい	継い 続い 續い
つづか	継か 続か
つづき	つゞき 継き 続き 續き
つづく	つゞく 継く 続く
つづけ	つゞけ 継け 続け 續け
つづける	つゞける 続ける
つづけれ	つゞけれ 続けれ
つづりあわせ	つづり合わせ 綴りあわせ 綴り合せ 綴り合わせ
つづりあわせる	つづり合わせる 綴り合せる 綴り合わせる
つづりかえ	つづり変え 綴り変え
つとまっ	務まっ 勤まっ
つとまら	務まら 勤まら
つとまり	務まり 勤まり
つとまる	務まる 勤まる
つとめ	力め 努め 勉め 務め 勤め
つとめあげ	務め上げ 勤めあげ 勤め上げ
つとめあげる	務め上げる 勤めあげる 勤め上げる
つとめあげれ	務め上げれ 勤め上げれ
つとめよ	努めよ 勉めよ 務めよ 勤めよ
つとめよう	努めよう 勉めよう 務めよう 勤めよう
つとめる	力める 努める 勉める 務める 勤める
つとめれ	努めれ 務めれ 勤めれ
つとめろ	務めろ 勤めろ
つとめん	努めん 勤めん
つない	繋い 繫い 連い
つなが	絡が 維が 繋が 繫が 連が
つながっ	繋がっ 繫がっ
つながら	繋がら 繫がら
つながり	繋がり 繫がり 繫り
つながりあい	つながり合い 繋がり合い
つながりあう	つながり合う 繋がり合う
つながりあっ	つながり合っ 繋がり合っ
つながる	繋がる 繫がる
つなぎ	繋ぎ 繫ぎ
つなぎあわ	つなぎ合わ 繋ぎ合わ
つなぎあわさ	つなぎ合わさ 繋ぎ合わさ
つなぎあわせ	つなぎ合わせ 繋ぎあわせ 繋ぎ合わせ 繫ぎ合わせ
つなぎあわせる	つなぎ合わせる 繋ぎあわせる 繋ぎ合わせる 繫ぎ合わせる
つなぎあわせれ	つなぎ合わせれ 繋ぎ合わせれ
つなぎかえ	つなぎ変え つなぎ替え 繋ぎ変え
つなぎかえる	つなぎ変える つなぎ替える 繋ぎかえる 繋ぎ変える
つなぎとめ	つなぎ止め つなぎ留め 繋ぎとめ 繋ぎ止め 繫ぎとめ 繫ぎ止め
つなぎとめよう	つなぎ止めよう つなぎ留めよう 繋ぎとめよう 繋ぎ止めよう
つなぎとめる	つなぎ止める つなぎ留める 繋ぎとめる 繋ぎ止める
つなぎなおし	つなぎ直し 繋ぎ直し
つなぎなおす	つなぎ直す 繋ぎ直す
つなぐ	繋ぐ 繫ぐ
つなげ	繋げ 繫げ
つなげあわせ	つなげ合わせ 繋げ合わせ
つなげあわせる	つなげ合わせる 繋げ合わせる
つなげる	繋げる 繫げる
つのだっ	つの立っ 角だっ
つぶす	ツブす 潰す
つぶやく	呟く 呟やく
つぶれ	ツブれ 潰れ 瞑れ
つぶれる	潰れる 瞑れる
つぼみ	窄み 蕾み
つま	摘ま 積ま 詰ま
つまさ	積まさ 詰まさ
つませ	積ませ 詰ませ
つまびい	つま弾い 爪弾い
つまびき	つま弾き 爪弾き
つまびく	つま弾く 爪弾く
つまみ	抓み 摘まみ 撮み
つまみあげ	つまみ上げ 摘まみ上げ 摘み上げ
つまみあげる	つまみ上げる 摘み上げる
つまみださ	つまみ出さ 摘み出さ
つまみだし	つまみ出し 摘み出し
つまみだそう	つまみ出そう 摘み出そう
つまみとっ	つまみ取っ 摘み取っ
つまみとる	つまみ取る 摘み取る
つまむ	抓む 摘まむ 摘む 撮む
つまめ	抓め 摘まめ
つまら	充ら 詰まら
つまる	充る 詰まる
つまん	抓ん 摘まん 撮ん 詰まん
つみ	摘み 積み 詰み
つみあがっ	積みあがっ 積み上がっ
つみあがり	積みあがり 積み上がり
つみあがる	積みあがる 積み上がる
つみあげ	積みあげ 積み上げ
つみあげる	積みあげる 積み上げる
つみあわせ	積み合わせ 積合せ
つみおろさ	積み下ろさ 積み降ろさ
つみおろし	積みおろし 積み下ろし 積み卸し 積み降し 積み降ろし 積下し
つみおろす	積み下ろす 積み卸す 積み降ろす
つみかえ	積みかえ 積み換え 積み替え
つみかえる	積みかえる 積み替える
つみかさなり	積みかさなり 積み重なり
つみかさなる	積みかさなる 積み重なる
つみかさね	つみ重ね 積み重ね
つみかさねれ	つみ重ねれ 積み重ねれ
つみこま	積みこま 積み込ま 積込ま
つみこみ	積みこみ 積み込み 積込み
つみこむ	積みこむ 積み込む 積込む
つみこめる	積みこめる 積み込める
つみこん	積みこん 積み込ん 積込ん
つみたて	積みたて 積み立て 積立て
つみたてる	積み立てる 積立てる
つみとっ	つみ取っ 摘みとっ 摘み取っ
つみとら	摘みとら 摘み取ら 摘み採ら
つみとり	摘みとり 摘み取り 摘み採り
つみとる	つみ取る 摘みとる 摘み取る
つむ	摘む 積む 詰む
つむぎ	紡ぎ 績ぎ
つむぎださ	紡ぎださ 紡ぎ出さ
つむぎだし	紡ぎだし 紡ぎ出し
つむぎだす	紡ぎだす 紡ぎ出す
つむぐ	紡ぐ 績ぐ
つめ	摘め 積め 詰め
つめかえ	詰めかえ 詰め替え
つめかけ	詰めかけ 詰め掛け
つめかけよう	詰めかけよう 詰め掛けよう
つめかける	詰めかける 詰め掛ける
つめこま	つめ込ま 詰めこま 詰め込ま 詰込ま
つめこみ	つめ込み 詰めこみ 詰め込み 詰込み
つめこむ	詰めこむ 詰め込む 詰込む
つめこん	つめ込ん 詰めこん 詰め込ん
つめよっ	つめ寄っ 詰めよっ 詰め寄っ 詰寄っ
つめよら	つめ寄ら 詰め寄ら
つめより	つめ寄り 詰めより 詰め寄り
つめよる	つめ寄る 詰めよる 詰め寄る 詰寄る
つめる	ツメる 摘める 積める 詰める
つめれ	ツメれ 詰めれ
つもう	摘もう 積もう
つもっ	ツモっ 積っ 積もっ
つもら	ツモら 積もら 積ら
つもり	ツモり 積もり 積り
つもりつもっ	積もりつもっ 積もり積もっ
つもる	ツモる 積もる 積る
つもれ	ツモれ 積もれ 積れ
つよめあい	強めあい 強め合い
つよめあう	強めあう 強め合う
つよめあっ	強めあっ 強め合っ
つら	吊ら 攣ら 連ら 釣ら
つらなっ	連っ 連なっ
つらなら	列なら 連なら 連ら
つらなり	列なり 連なり 連り
つらなる	列なる 連なる 連る
つらぬい	貫い 貫ぬい
つらぬき	貫き 貫ぬき
つらぬきとおし	貫きとおし 貫き通し
つらぬきとおす	貫きとおす 貫き通す
つらぬく	貫く 貫ぬく
つらね	列ね 連ね 連らね
つらねる	列ねる 連ねる 連らねる
つり	吊り 攣り 連り 釣り
つりあい	つり合い 吊り合い 釣り合い 釣合い
つりあう	つり合う 吊り合う 釣り合う 釣合う
つりあがっ	つり上がっ 吊りあがっ 吊り上がっ 吊り上っ 釣りあがっ 釣り上がっ
つりあがり	つり上がり 吊り上がり 吊り上り 釣りあがり 釣り上がり
つりあがる	つり上がる 吊り上がる 釣りあがる 釣り上がる
つりあげ	つり上げ 吊りあげ 吊り上げ 釣りあげ 釣り上げ
つりあげよう	つり上げよう 吊り上げよう 釣り上げよう
つりあげる	つり上げる 吊りあげる 吊り上げる 釣りあげる 釣り上げる
つりあっ	つり合っ 吊り合っ 釣り合っ 釣合っ
つりあわ	つり合わ 吊り合わ 釣り合わ 釣合わ
つりおとし	つり落とし 吊り落とし 釣り落とし
つりこま	吊り込ま 釣り込ま
つりこみ	吊り込み 釣り込み
つりこん	吊り込ん 釣り込ん
つりさがっ	つり下がっ 吊り下がっ 釣り下がっ
つりさがる	つり下がる 吊り下がる 釣り下がる
つりさげ	つり下げ 吊りさげ 吊り下げ 釣り下げ
つりさげる	つり下げる 吊り下げる 釣り下げる
つりださ	吊り出さ 釣り出さ
つりだし	つり出し 吊り出し 釣り出し
つりだす	つり出す 吊り出す 釣り出す
つる	吊る 攣る 連る 釣る
つるさ	吊さ 吊るさ
つるし	吊し 吊るし
つるしあげ	つるし上げ 吊し上げ 吊るしあげ 吊るし上げ
つるしあげよう	吊し上げよう 吊るしあげよう
つるしあげる	つるし上げる 吊し上げる 吊るし上げる
つるしあげろ	吊し上げろ 吊るし上げろ
つるす	吊す 吊るす
つるせ	吊せ 吊るせ
つるせる	吊せる 吊るせる
つれ	伴れ 吊れ 連れ 釣れ
つれあるい	つれ歩い 連れ歩い
つれあるき	連れあるき 連れ歩き
つれあるく	連れあるく 連れ歩く
つれかえさ	連れ帰さ 連れ返さ
つれかえそう	連れ帰そう 連れ返そう
つれかえっ	つれ帰っ 連れかえっ 連れ帰っ
つれかえる	つれ帰る 連れ帰る
つれこま	連れこま 連れ込ま
つれこみ	連れこみ 連れ込み
つれこん	連れこん 連れ込ん
つれさっ	つれ去っ 連れ去っ
つれさら	連れさら 連れ去ら
つれさり	つれ去り 連れ去り
つれそい	連れそい 連れ添い
つれそう	つれ添う 連れ添う
つれださ	つれ出さ 連れださ 連れ出さ
つれだし	連れだし 連れ出し
つれだす	つれ出す 連れだす 連れ出す
つれだそう	連れだそう 連れ出そう
つれだっ	連れだっ 連れ立っ 連立っ
つれまわさ	連れまわさ 連れ回さ
つれまわし	連れまわし 連れ回し
つれまわす	連れまわす 連れ回す
つれもどさ	つれ戻さ 連れもどさ 連れ戻さ
つれもどし	つれ戻し 連れ戻し
つれもどす	つれ戻す 連れ戻す
つれもどっ	連れもどっ 連れ戻っ
つれる	吊れる 連れる 釣れる
つろう	吊ろう 釣ろう
つん	摘ん 積ん 詰ん
つんざい	つん裂い 劈い
づい	憑い 点い
づけ	了 付 付け 就け 点け 狙 着け 附 附け 點
づける	付ける 付る 着ける 附ける
ていし	呈し 挺し 訂し
ていする	呈する 挺する 訂する
てがけ	手がけ 手懸け 手掛け
てがけよう	手がけよう 手掛けよう
てがける	手がける 手懸ける 手掛ける
てきし	敵し 適し
てきす	敵す 適す
てきする	敵する 適する
てきせ	敵せ 適せ
てこずっ	手こずっ 手古摺っ 梃子摺っ
てこずり	手こずり 手古摺り
てこずる	手こずる 梃摺る
てっし	徹し 撤し
てっする	徹する 撤する
てっせ	徹せ 撤せ
てつだっ	手つだっ 手伝っ
てつどう	手伝 手伝う
てなずけ	手なずけ 手懐け
てなずけよう	手なずけよう 手懐けよう
てなずける	手なずける 手懐ける
てなれ	手なれ 手慣れ 手馴れ
てばなさ	手放さ 手離さ
てばなし	手放し 手離し
てばなす	手放す 手離す
てばなせ	手放せ 手放なせ 手離せ
てばなそう	手放そう 手離そう
てまどっ	手間どっ 手間取っ
てまどり	手間どり 手間取り
てまどる	手間どる 手間取る
てら	照ら 輝ら
てらさ	照さ 照らさ
てらし	照し 照らし
てらしあわせ	照らしあわせ 照らし合せ 照らし合わせ
てらしあわせる	てらし合わせる 照らしあわせる 照らし合せる 照らし合わせる
てらしださ	照らしださ 照らし出さ
てらしだし	照し出し 照らしだし 照らし出し
てらしだす	照らしだす 照らし出す
てらす	照す 照らす
てりかがやい	照りかがやい 照り輝い
てりかがやく	照りかがやく 照り輝く
てりつけ	照りつけ 照り付け
てりつける	照りつける 照り付ける
てる	照る 輝る
てれ	照れ 輝れ
てれる	テレる 照れる
てんじ	点じ 転じ 轉じ
てんじる	点じる 転じる
てんずる	点ずる 転ずる
てんぜ	転ぜ 轉ぜ
であい	出あい 出会い 出合い 出逢い 出遇い 出遭い
であう	出あう 出会う 出合う 出逢う 出遇う 出遭う
であえ	出会え 出合え 出逢え
であえる	出会える 出合える 出逢える
であっ	出あっ 出会っ 出合っ 出逢っ 出遇っ 出遭っ
であるく	出あるく 出歩く
であわ	出会わ 出合わ 出逢わ 出遇わ 出遭わ
でかかっ	出かかっ 出掛かっ
でかけ	出かけ 出掛け
でかけよう	出かけよう 出掛けよう
でかける	出かける 出懸ける 出掛ける
でかけれ	出かけれ 出掛けれ
でかし	出かし 出来し
でき	出き 出来
できあがっ	でき上がっ でき上っ 出来あがっ 出来上がっ 出来上っ
できあがら	でき上がら 出来上がら
できあがり	でき上がり 出来あがり 出来上がり
できあがる	でき上がる でき上る 出来あがる 出来上がる
できる	デキる 出きる 出来る
でくわし	出くわし 出会し
でくわす	出くわす 出会す 出喰わす
でそろい	出そろい 出揃い
でそろう	出そろう 出揃う
でそろっ	出そろっ 出揃っ
でそろわ	出そろわ 出揃わ
でっちあげ	でっち上げ デッチあげ デッチ上げ 捏ち上げ
でっちあげよう	でっち上げよう デッチあげよう
でっぱっ	出っぱっ 出っ張っ
でまわっ	出まわっ 出回っ 出廻っ
でまわら	出まわら 出回ら
でまわり	出まわり 出回り
でまわる	出まわる 出回る 出廻る
でむき	出むき 出向き
でむく	出むく 出向く
とい	問い 溶い 研い 砥い 磨い 解い 説い 鋭い
といあわせ	問いあわせ 問い合せ 問い合わせ 問合せ
といあわせる	問いあわせる 問い合せる 問い合わせる 問合せる
といかけ	問いかけ 問い掛け
といかける	問いかける 問い掛ける
といたださ	問いたださ 問い正さ 問い質さ
といただし	問いただし 問い正し 問い質し
といただす	問いただす 問い正す 問い質す
といただそう	問いただそう 問い正そう 問い質そう
といつめ	問いつめ 問い詰め
といつめる	問いつめる 問い詰める
といなおさ	問いなおさ 問い直さ
といなおし	問いなおし 問い直し
といなおす	問いなおす 問い直す
とうとば	尊ば 尚ば 貴ば
とうとぶ	尊ぶ 尚ぶ 貴ぶ
とうとべ	尊べ 貴べ
とうとぼう	尊ぼう 貴ぼう
とうとん	尊ん 尚ん 貴ん
とおさ	徹さ 透さ 通さ
とおざかっ	遠かっ 遠ざかっ 遠去かっ
とおざから	遠から 遠ざから
とおざかる	遠ざかる 遠去かる
とおざけ	遠ざけ 遠避け
とおざけよう	遠ざけよう 遠避けよう
とおざける	遠ざける 遠避ける
とおし	徹し 透し 通し
とおす	徹す 透す 通す
とおそう	徹そう 通そう
とおっ	透っ 通っ
とおのい	遠のい 遠退い
とおのき	遠のき 遠退き
とおのく	遠のく 遠退く
とおら	徹ら 透ら 通ら
とおり	徹り 通り
とおりあわせ	通りあわせ 通り合わせ
とおりかかっ	通りかかっ 通り掛かっ
とおりかかり	通りかかり 通り掛かり
とおりかかる	通りかかる 通り掛かる
とおりこし	通りこし 通り越し
とおりすぎ	通りすぎ 通り過ぎ
とおりすぎよう	通りすぎよう 通り過ぎよう
とおりすぎる	通りすぎる 通り過ぎる
とおりぬけ	通りぬけ 通り抜け
とおりぬける	通りぬける 通り抜ける
とおる	徹る 透る 通る
とか	溶か 解か 説か
とかさ	梳かさ 溶かさ 熔かさ 融かさ 解かさ
とかし	梳かし 溶かし 熔かし 融かし 解かし
とかしこみ	溶かしこみ 溶かし込み
とかしこむ	溶かしこむ 溶かし込む
とかしこん	溶かしこん 溶かし込ん
とかす	梳かす 溶かす 熔かす 融かす 解かす
とかそう	溶かそう 熔かそう
とが	研が 砥が 磨が
とがっ	トガっ 尖っ
とき	溶き 解き 説き 釈き
ときあかさ	とき明かさ 解き明かさ 説きあかさ 説き明かさ
ときあかし	解きあかし 解き明かし 説き明かし
ときあかす	解きあかす 解き明かす 説き明かす
ときあかそう	解き明かそう 説き明かそう
ときおこし	説きおこし 説き起こし
ときおよび	説き及び 説及び
とききかせ	説ききかせ 説き聞かせ
ときさとす	説きさとす 説き諭す
ときすすめ	解き進め 説きすすめ 説き勧め
ときつけ	説きつけ 説き付け
ときはなし	解き放し 解き離し
ときはなち	解きはなち 解き放ち
ときはなっ	解きはなっ 解き放っ
ときふせ	説きふせ 説き伏せ
ときほぐさ	溶きほぐさ 解きほぐさ
ときほぐし	溶きほぐし 解きほぐし
とぎ	研ぎ 砥ぎ 磨ぎ
とぎあげ	研ぎあげ 研ぎ上げ
とぎすまさ	研ぎすまさ 研ぎ澄まさ
とぎすます	研ぎすます 研ぎ澄ます
とぎれ	跡切れ 途切れ
とぎれる	跡切れる 途切れる
とく	溶く 解く 説く 釈く
とくし	得し 督し
とくする	得する 督する
とぐ	研ぐ 砥ぐ 磨ぐ
とけ	溶け 熔け 融け 解け 説け 釈け
とけあい	溶け合い 融けあい 解け合い
とけあう	溶けあう 溶け合う 融けあう 融け合う 解けあう 解け合う
とけあっ	溶けあっ 溶け合っ 融けあっ 融け合っ 解け合っ
とけあわ	溶けあわ 溶け合わ 融け合わ 解け合わ
とけこま	とけ込ま 溶けこま 溶け込ま
とけこみ	とけ込み 溶けこみ 溶け込み 融けこみ
とけこむ	とけ込む 溶けこむ 溶け込む 溶込む
とけこめ	とけ込め 溶けこめ 溶け込め
とけこめる	とけ込める 溶け込める
とけこもう	とけ込もう 溶け込もう
とけこん	とけ込ん 溶けこん 溶け込ん 融けこん
とけさっ	とけ去っ 溶け去っ
とけだし	とけ出し 溶けだし 溶け出し
とけだす	溶けだす 溶け出す
とける	溶ける 熔ける 融ける 解ける 説ける
とけれ	溶けれ 融けれ 解けれ
とげ	研げ 砥げ 遂げ
とこう	解こう 説こう
とざさ	塞さ 閉さ 閉ざさ
とざし	塞し 閉ざし 閉し
とざす	閉ざす 閉す
としおい	年おい 年老い
としとり	年取り 年老り
とじ	綴じ 閉じ
とじあわせ	綴じ合わせ 閉じ合わせ
とじあわせる	綴じ合わせる 閉じ合わせる
とじこま	とじ込ま 綴じ込ま
とじこめ	とじ込め 閉じこめ 閉じ籠め 閉じ込め 閉込め
とじこめよう	閉じこめよう 閉じ込めよう
とじこめる	とじ込める 閉じこめる 閉じ込める
とじこめれ	閉じこめれ 閉じ込めれ
とじこもっ	とじ籠っ 閉じこもっ 閉じ篭っ 閉じ籠っ 閉じ籠もっ 閉じ込もっ
とじこもら	閉じこもら 閉じ籠ら
とじこもり	閉じこもり 閉じ篭り 閉じ籠もり 閉じ籠り
とじこもる	閉じこもる 閉じ篭る 閉じ籠もる 閉じ籠る
とじこん	とじ込ん 綴じ込ん
とじる	綴じる 閉じる
とだえ	跡絶え 途絶え
とだえる	跡絶える 途断える 途絶える
とちくるっ	とち狂っ トチ狂っ
とっ	とッ 取っ 取ッ 問っ 執っ 奪ッ 征っ 捕っ 採っ 摂っ 撮っ 獲っ 盗っ 買ッ 録っ
とっかえ	取っかえ 取っ替え
とっつき	取っつき 取っ付き
とっつく	取っつく 取っ付く
とつぎ	婚ぎ 嫁ぎ
ととのい	整い 調い
ととのう	整う 調う
ととのえ	整え 斉え 調え
ととのえる	整える 調える
ととのっ	整っ 調っ
ととのわ	整わ 調わ
とどく	屆く 届く
とどけ	屆け 届け
とどけで	届けで 届け出 届出
とどけでる	届けでる 届け出る 届出る
とどけでれ	届け出れ 届出れ
とどまっ	止どまっ 滞まっ 留まっ
とどまら	止どまら 留まら
とどまり	止どまり 滞まり 留まり
となえ	唱え 唱へ 誦え
となえよ	唱えよ 唱へよ
となえん	唱えん 唱へん
となりあい	隣りあい 隣り合い 隣合い
となりあう	となり合う 隣りあう 隣り合う 隣合う
となりあっ	となり合っ 隣りあっ 隣り合っ 隣合っ
となりあわ	となり合わ 隣り合わ 隣合わ
とば	トば 翔ば 跳ば 飛ば
とばさ	跳ばさ 飛ばさ
とばし	跳ばし 飛ばし
とばす	跳ばす 飛ばす
とばそう	跳ばそう 飛ばそう
とび	トび 翔び 跳び 飛び
とびあがっ	とび上がっ 跳びあがっ 跳び上がっ 飛びあがっ 飛び上がっ 飛び上っ
とびあがら	跳びあがら 跳び上がら 飛び上がら 飛び上ら
とびあがり	とび上り 跳びあがり 跳び上がり 飛びあがり 飛び上がり 飛上り
とびあがる	跳びあがる 跳び上がる 飛びあがる 飛び上がる 飛び上る
とびあがれ	跳び上がれ 飛び上がれ 飛び上れ
とびあがれる	飛びあがれる 飛び上がれる
とびあがろう	跳び上がろう 飛び上がろう
とびいり	とび入り 飛び入り 飛入り
とびおり	とび下り とび降り 跳びおり 跳び下り 跳び降り 飛びおり 飛び下り 飛び降り 飛降り
とびおりよう	飛びおりよう 飛び降りよう
とびおりる	跳び下りる 跳び降りる 飛び下りる 飛び降りる 飛降りる
とびかい	飛びかい 飛び交い
とびかう	飛びかう 飛び交う 飛交う
とびかえり	飛び帰り 飛び返り
とびかかっ	飛びかかっ 飛び掛かっ
とびかから	飛びかから 飛び掛から
とびかかり	飛びかかり 飛び掛かり
とびかかる	飛びかかる 飛び掛かる
とびかかろう	飛びかかろう 飛び掛かろう
とびかっ	飛びかっ 飛び交っ
とびこえ	とび越え 跳びこえ 跳び越え 飛びこえ 飛び超え 飛び越え
とびこえよう	跳び越えよう 飛び越えよう
とびこえる	跳び越える 飛び超える 飛び越える
とびこさ	飛び越さ 飛越さ
とびこし	跳び越し 飛びこし 飛び越し 飛越し
とびこす	跳び越す 飛びこす 飛び越す
とびこま	飛びこま 飛び込ま
とびこみ	飛びこみ 飛び込み
とびこむ	飛びこむ 飛び込む
とびこめる	飛びこめる 飛び込める
とびこもう	飛びこもう 飛び込もう
とびこん	とび込ん 飛びこん 飛び込ん
とびさっ	飛びさっ 飛び去っ
とびさる	翔び去る 飛びさる 飛び去る
とびたち	飛び発ち 飛び立ち 飛立ち
とびたっ	飛びたっ 飛び発っ 飛び立っ 飛立っ
とびたつ	とび立つ 翔び立つ 飛びたつ 飛び発つ 飛び立つ 飛立つ
とびたて	飛びたて 飛び立て
とびたてる	飛びたてる 飛び立てる
とびたとう	飛びたとう 飛び立とう
とびだし	とび出し 飛びだし 飛び出し 飛出し
とびだす	とび出す 飛びだす 飛び出す 飛出す
とびだせ	とび出せ 飛びだせ 飛び出せ
とびだそう	とび出そう 飛びだそう 飛び出そう
とびちっ	とび散っ 飛び散っ
とびちる	飛び散る 飛散る
とびつい	飛びつい 飛び付い
とびつか	飛びつか 飛び付か
とびつき	跳びつき 飛びつき 飛び付き 飛付き
とびつく	跳びつく 飛びつく 飛び付く
とびで	飛び出 飛出
とびでる	飛び出る 飛出る
とびぬけ	とび抜け 飛びぬけ 飛び抜け
とびぬける	飛びぬける 飛び抜ける
とびのい	飛びのい 飛び退い
とびのり	とび乗り 飛び乗り 飛乗り
とびはね	とび跳ね 跳びはね 飛びはね 飛び跳ね
とびはねる	とび跳ねる 跳びはねる 飛び跳ねる 飛跳ねる
とびまわっ	飛びまわっ 飛び回っ 飛び廻っ
とびまわら	飛びまわら 飛び回ら
とびまわり	飛びまわり 飛び回り 飛び廻り 飛廻り
とびまわる	飛びまわる 飛び回る 飛び廻る
とびまわれ	飛びまわれ 飛び回れ
とふ	問ふ 訪ふ
とぶ	トぶ 翔ぶ 跳ぶ 飛ぶ
とべ	トべ 翔べ 跳 跳べ 飛 飛べ
とべる	翔べる 跳べる 飛べる
とぼ	トぼ 飛ぼ
とぼう	トぼう 跳ぼう 飛ぼう
とま	富ま 止ま
とまっ	停っ 停まっ 止っ 止まっ 止ッ 泊っ 泊まっ 留っ 留まっ 駐まっ
とまどう	戸惑う 途惑う
とまどっ	戸惑っ 途惑っ
とまどわ	戸惑わ 途惑わ
とまら	停まら 止まら 止ら 泊まら 泊ら 留ら
とまり	停まり 止まり 止り 泊まり 泊り 留まり 留り
とまりあるい	泊まり歩い 泊り歩い
とまりこま	泊まり込ま 泊り込ま
とまりこみ	泊まりこみ 泊まり込み 泊り込み
とまりこむ	泊まりこむ 泊まり込む 泊り込む
とまりこん	泊まりこん 泊まり込ん 泊り込ん
とまる	停まる 停る 止まる 止る 泊まる 泊る 留まる 留る 駐まる 駐る
とまれ	停まれ 止まれ 泊まれ 留まれ
とまれる	停まれる 止まれる 泊まれる 泊れる 留まれる
とまろう	止まろう 泊まろう 留まろう
とめ	停め 富め 止め 泊め 留め 駐め
とめおい	止め置い 留めおい 留め置い
とめおか	止め置か 留めおか 留め置か
とめおき	留めおき 留め置き 留置き
とめおく	留めおく 留め置く
とめおけ	留めおけ 留め置け
とめおこう	留めおこう 留め置こう
とめよ	止めよ 留めよ
とめよう	停めよう 止めよう 泊めよう 留めよう
とめる	停める 止める 泊める 留める 駐める
とめれ	停めれ 止めれ 留めれ
とめろ	停めろ 止めろ 泊めろ
とめん	止めん 留めん
ともさ	灯さ 点さ 燈さ
ともし	灯し 点し 燈し
ともす	灯す 点す 燈す
ともせ	灯せ 点せ
ともっ	灯っ 点っ 燈っ
ともない	伴い 伴ない
ともなう	伴う 伴なう
ともなえ	伴 伴え
ともなっ	伴っ 伴なっ
ともなわ	伴なわ 伴わ
ともら	灯ら 点ら 燈ら
ともり	灯り 点り 燈り
ともる	灯る 点る 燈る
ともれ	灯れ 点れ
とら	取ら 執ら 奪ら 征ら 捕ら 採ら 摂ら 撮ら 獲ら 盗ら 録ら
とらえ	囚え 把え 捉え 捉らえ 捕え 捕らえ
とらえかえす	とらえ返す 捉え返す
とらえかえそう	とらえ返そう 捉え返そう
とらえなおさ	とらえ直さ 捉えなおさ 捉え直さ
とらえなおし	とらえ直し 捉えなおし 捉え直し
とらえなおす	とらえ直す 捉えなおす 捉え直す
とらえなおそう	とらえ直そう 捉えなおそう 捉え直そう
とらえよ	捉えよ 捕えよ 捕らえよ
とらえよう	捉えよう 捕えよう 捕らえよう
とらえる	囚える 把える 捉える 捕える 捕らえる
とらえれ	捉えれ 捕えれ 捕らえれ
とらさ	取らさ 撮らさ 録らさ
とらし	取らし 撮らし
とらす	取らす 撮らす
とらわれ	囚はれ 囚れ 囚われ 執われ 捉はれ 捉われ 捕らわれ 捕われ
とらわれる	囚われる 捉われる 捕らわれる 捕われる
とり	取り 執り 奪り 捕り 採り 摂り 撮り 獲り 盗り 録り
とりあい	とり合い 取りあい 取り合い 取合い
とりあう	とり合う 取りあう 取り合う 取合う
とりあおう	取りあおう 取り合おう 取合おう
とりあげ	とり上げ とり挙げ 取りあげ 取り上 取り上げ 取り挙げ 取り揚げ 取上げ 採りあげ 採り上げ
とりあげよう	取りあげよう 取り上げよう
とりあげる	とり上げる 取りあげる 取り上げる 取り挙げる 取上げる 採りあげる 採り上げる
とりあげれ	取り上げれ 取上げれ
とりあっ	とり合っ 取りあっ 取り合っ
とりあつかい	とり扱い 取りあつかい 取り扱い
とりあつかう	とり扱う 取りあつかう 取り扱う
とりあつかえ	取り扱え 取扱え
とりあつかえる	とり扱える 取りあつかえる 取り扱える 取扱える
とりあつかっ	とり扱っ 取りあつかっ 取り扱っ
とりあつかわ	とり扱わ 取りあつかわ 取り扱わ
とりあつめ	とり集め 取り集め 取集め 採り集め
とりあわ	とり合わ 取りあわ 取り合わ 取合わ
とりあわせ	とり合わせ 取り合せ 取り合わせ
とりあわせる	とり合わせる 取り合わせる
とりいそぎ	とり急ぎ 取り急ぎ
とりいっ	とり入っ 取りいっ 取り入っ
とりいり	とり入り 取り入り 取入り
とりいる	とり入る 取りいる 取り入る
とりいれ	とり入れ 取りいれ 取り入れ 取入れ 採りいれ 採り入れ 摂り入れ
とりいれよう	取り入れよう 採り入れよう
とりいれる	とり入れる 取りいれる 取り入れる 取入れる 採りいれる 採り入れる 摂り入れる
とりいれれ	取り入れれ 採り入れれ
とりおこない	とり行い 取り行い 執りおこない 執り行い 執り行ない
とりおこなう	とり行う とり行なう 取り行う 執りおこなう 執り行う 執り行なう
とりおこなえ	執り行え 執行
とりおこなえる	執り行える 執り行なえる
とりおこなおう	執り行おう 執り行なおう
とりおこなっ	とり行っ とり行なっ 取り行っ 取り行なっ 執りおこなっ 執り行っ 執り行なっ
とりおこなわ	とり行なわ とり行わ 取り行なわ 取り行わ 執りおこなわ 執り行なわ 執り行わ
とりおさえ	とり押さえ 取りおさえ 取り抑え 取り押え 取り押さえ 取押え 取押さえ 捕り押さえ
とりおさえよう	取りおさえよう 取り押さえよう
とりおさえる	取りおさえる 取り抑える 取り押さえる 取押える
とりおとし	取り落し 取り落とし
とりおろし	とり下ろし 取り下ろし 取り卸し 取り降ろし 撮り下ろし
とりおろす	取り下ろす 取り卸す 取り降ろす 撮り下ろす
とりかえ	取りかえ 取り代え 取り変え 取り換え 取り替え 取替え
とりかえさ	取りかえさ 取り返さ
とりかえし	とり返し 取りかえし 取り返し 取返し
とりかえす	とり返す 取りかえす 取り返す 取返す
とりかえせ	とり返せ 取り返せ
とりかえそう	取り返そう 取返そう
とりかえよう	取り換えよう 取り替えよう 取替えよう
とりかえる	とり替える 取りかえる 取り変える 取り換える 取り替える 取替える
とりかえれ	取り換えれ 取り替えれ
とりかえろ	取り換えろ 取り替えろ
とりかかっ	取りかかっ 取り掛かっ 取り掛っ 取掛かっ
とりかから	取りかから 取り掛から
とりかかり	取りかかり 取り掛かり 取り掛り 取掛かり
とりかかる	取りかかる 取り掛かる 取り掛る 取掛かる
とりかかれ	取りかかれ 取り掛かれ
とりかかれる	取りかかれる 取り掛かれる
とりかかろう	取りかかろう 取り掛かろう
とりかこま	とり囲ま 取りかこま 取り囲ま 取囲ま
とりかこみ	とり囲み 取り囲み
とりかこむ	とり囲む 取りかこむ 取り囲む 取囲む
とりかこん	とり囲ん 取り囲ん 取囲ん
とりかわさ	とり交わさ 取り交さ 取り交わさ
とりかわす	取り交す 取り交わす
とりきめ	とり決め 取りきめ 取り極め 取り決め 取極め 取決め
とりくずし	取り崩し 取崩し
とりくずす	取り崩す 取崩す
とりくま	取りくま 取り組ま
とりくみ	とり組み 取りくみ 取り組み
とりくむ	とり組む 取りくむ 取り組む
とりくめる	取りくめる 取り組める
とりくん	とり組ん 取りくん 取り組ん
とりけさ	とり消さ 取り消さ 取消さ
とりけし	とり消し 取り消し 取消し
とりけす	取り消す 取消す
とりけせ	取り消せ 取消せ
とりけそう	取り消そう 取消そう
とりこぼし	取りこぼし 取り零し
とりこぼす	取りこぼす 取り零す
とりこま	とり込ま 取りこま 取り込ま 取込ま
とりこみ	とり込み 取りこみ 取り込み 取込み
とりこむ	取りこむ 取り込む 取込む
とりこめ	取りこめ 取り籠め 取り込め
とりこめる	取りこめる 取り籠める 取り込める
とりこもう	とり込もう 取りこもう 取り込もう
とりころし	とり殺し 取り殺し 取殺し
とりころす	とり殺す 取り殺す 取殺す
とりこわさ	とり壊さ 取りこわさ 取り壊さ 取壊さ
とりこわし	とり壊し 取りこわし 取り壊し 取り毀し 取壊し 取毀し
とりこわす	とり壊す 取り壊す 取壊す
とりこん	とり込ん 取りこん 取り込ん 取込ん
とりさげ	取りさげ 取り下げ 取下げ
とりさげる	取り下げる 取下げる
とりさばく	取りさばく 取り捌く
とりさら	取りさら 取り去ら
とりさり	とり去り 取り去り 取去り
とりされ	取りされ 取り去れ
とりしきっ	とり仕切っ 取りしきっ 取り仕切っ 執りしきっ 執り仕切っ
とりしきり	とり仕切り 取りしきり 取り仕切り 執り仕切り
とりしきる	とり仕切る 取りしきる 取り仕切る 執り仕切る
とりしずめ	取り鎮め 取り静め 取鎮め
とりしずめる	取り鎮める 取り静める 取鎮める
とりしまっ	取りしまっ 取り締っ 取り締まっ 取締まっ
とりしまら	取りしまら 取り締まら 取り締ら 取締まら
とりしまり	取り締まり 取り締り 取締まり
とりしまる	取りしまる 取り締まる 取り締る 取締まる
とりしらべ	取り調べ 取調べ
とりしらべよう	取り調べよう 取調べよう
とりしらべる	取り調べる 取調べる
とりすがっ	取りすがっ 取り縋っ
とりすがる	取りすがる 取り縋る
とりすすめ	取り進め 撮り進め
とりすまし	取りすまし 取り澄まし 取澄まし
とりそろえ	取りそろえ 取り揃え 取揃え
とりそろえる	取りそろえる 取り揃える 取揃える
とりたて	とり立て 取りたて 取り立て 取立て
とりたてよう	取りたてよう 取り立てよう
とりたてる	取りたてる 取り立てる 取立てる
とりため	撮りため 撮り溜め 撮り貯め
とりためる	撮り溜める 撮り貯める
とりださ	とり出さ 取りださ 取り出さ 取出さ
とりだし	とり出し 取りだし 取り出し 取出し
とりだす	とり出す 取りだす 取り出す 取出す
とりだせ	取り出せ 取出せ
とりだそう	取りだそう 取り出そう 取出そう
とりちがえ	とり違え 取りちがえ 取り違え 取違え
とりちらかっ	とり散らかっ 取り散らかっ
とりつい	とり憑い 取りつい 取り付い 取り憑い 取り次い 取次い
とりつか	とり憑か 取りつか 取り付か 取り憑か
とりつが	取り次が 取り継が 取次が
とりつき	とり憑き 取りつき 取り付き 取り憑き 取付き
とりつぎ	取り次ぎ 取り継ぎ 取次ぎ
とりつく	とり憑く 取りつく 取り付く 取り憑く 取り着く 取付く
とりつくろい	取り繕い 取繕い
とりつくろう	取りつくろう 取り繕う
とりつくろおう	取りつくろおう 取り繕おう
とりつくろっ	取りつくろっ 取り繕っ 取繕っ
とりつぐ	とり継ぐ 取りつぐ 取り次ぐ 取り継ぐ 取次ぐ
とりつけ	とり付け 取りつけ 取り付け 取り着け 取付 取付け
とりつけよう	取りつけよう 取り付けよう
とりつける	取りつける 取り付ける 取り憑ける 取り着ける 取付ける 取付る
とりつこう	取りつこう 取り付こう 取り憑こう
とりつぶさ	取りつぶさ 取り潰さ 取潰さ
とりつぶし	取りつぶし 取り潰し 取潰し
とりとめ	取りとめ 取り止め 取り留め
とりとめる	取りとめる 取り止める 取り留める
とりなおさ	取り直さ 撮り直さ
とりなおし	とり直し 取りなおし 取り直し 取直し 撮り直し
とりなおす	とり直す 取りなおす 取り直す 撮り直す
とりなおそう	取りなおそう 取り直そう 撮り直そう
とりなさ	取りなさ 取り成さ
とりなし	とり成し 取りなし 取り成し 執りなし 執り成し
とりなす	取りなす 取り成す 執り成す
とりなそう	取りなそう 取り成そう 執り成そう
とりにがし	取り逃がし 取り逃し 捕り逃がし
とりにがす	取り逃がす 取り逃す
とりのがし	取り逃がし 撮り逃がし
とりのがす	とり逃がす 取り逃がす
とりのけ	取りのけ 取り除け
とりのける	取りのける 取り除ける
とりのこさ	とり残さ 取り残さ 取残さ
とりのぞい	とり除い 取りのぞい 取り除い 取除い
とりのぞか	とり除か 取りのぞか 取り除か 取除か
とりのぞき	とり除き 取りのぞき 取り除き 取除き
とりのぞく	とり除く 取りのぞく 取り除く 取除く
とりのぞけ	とり除け 取り除け
とりのぞこう	とり除こう 取り除こう
とりはからい	取りはからい 取り計い 取り計らい
とりはからう	取りはからう 取り計らう 取計らう
とりはからっ	取りはからっ 取り計っ 取り計らっ 取計らっ
とりはからわ	取り計らわ 取計らわ
とりはずさ	取りはずさ 取り外さ 取外さ
とりはずし	とり外し 取りはずし 取り外し 取外し
とりはずす	取りはずす 取り外す 取外す
とりはずせる	取り外せる 取外せる
とりはなし	取り放し 取り離し
とりはらい	取り払い 取払い
とりはらう	取りはらう 取り払う
とりはらっ	取りはらっ 取り払っ 取払っ
とりはらわ	取り払わ 取払わ
とりまい	とり巻い 取りまい 取り巻い 取巻い
とりまか	取り巻か 取巻か
とりまき	とり巻き 取り巻き 取り捲き 取巻き
とりまく	とり巻く 取りまく 取り巻く 取巻く
とりまぜ	とり交ぜ とり混ぜ 取りまぜ 取り交ぜ 取り混ぜ 取混ぜ
とりまとめ	取りまとめ 取り纏め 取纏め
とりまとめる	取りまとめる 取り纏める
とりまわし	取りまわし 取り回し
とりまわす	取り回す 取り廻す
とりみだし	とり乱し 取り乱し 取乱し
とりみだす	とり乱す 取り乱す
とりむすば	とり結ば 取り結ば
とりむすび	取り結び 取結び
とりむすぶ	とり結ぶ 取り結ぶ
とりもち	取りもち 取り持ち 取持ち
とりもっ	取りもっ 取り持っ 取持っ
とりもつ	とり持つ 取りもつ 取り持つ 取持つ
とりもとう	取りもとう 取り持とう 取持とう
とりもどし	とり戻し 取りもどし 取り戻し 取戻し
とりもどす	とり戻す 取りもどす 取り戻す 取戻す
とりもどせ	とり戻せ 取りもどせ 取り戻せ
とりもどそう	とり戻そう 取りもどそう 取り戻そう 取戻そう
とりやめ	とり止め 取りやめ 取り止め 取止め
とりやめよ	取りやめよ 取止めよ
とりやめよう	取りやめよう 取り止めよう
とりやめる	取りやめる 取り止める 取止める
とりよせ	とり寄せ 取りよせ 取り寄せ 取寄せ
とりよせる	取りよせる 取り寄せる 取寄せる
とりわけ	とり分け 取りわけ 取り分け 取分け 撮り分け
とりわける	取り分ける 撮り分ける
とる	取る 執る 奪る 捕る 採る 摂る 撮る 獲る 盗る 録る
とれ	勝れ 取れ 執れ 奪れ 捕れ 採れ 摂れ 撮れ 漁れ 獲れ 盗れ 穫れ 録れ
とれよ	捕れよ 撮れよ
とれる	取れる 執れる 捕れる 採れる 摂れる 撮れる 獲れる 穫れる 録れる
とれれ	取れれ 摂れれ 撮れれ 獲れれ
とろう	取ろう 執ろう 捕ろう 採ろう 摂ろう 撮ろう 獲ろう 盗ろう 録ろう
とろけ	トロけ 溶ろけ 蕩け
とん	奪ん 富ん 疾ん 翔ん 跳ん 飛ん
どうじ	動じ 同じ
どうずる	動ずる 同ずる
どうぜ	動ぜ 同ぜ
どくづい	毒づい 毒突い
どくづき	毒づき 毒付き 毒突き
どくづく	毒づく 毒付く 毒突く
どつい	ど突い ドツい
どつき	ど突き ドツき
どなりあい	怒鳴りあい 怒鳴り合い
どなりあう	怒鳴りあう 怒鳴り合う
どなりあっ	怒鳴りあっ 怒鳴り合っ
どなりかえし	どなり返し 怒鳴り返し
どなりこみ	どなり込み 怒鳴り込み
どなりこむ	どなり込む 怒鳴り込む
どなりこん	どなり込ん 怒鳴り込ん
どなりちらす	怒鳴りちらす 怒鳴り散らす
どなりつけ	怒鳴りつけ 怒鳴り付け
どなりつける	怒鳴りつける 怒鳴り付ける
ない	凪い 和い 啼い 泣い 綯い 薙い 鳴い
ないまぜ	ない交ぜ ない混ぜ 綯い交ぜ 綯交ぜ
なおさ	治さ 療さ 直さ
なおし	治し 療し 直し
なおす	治す 療す 直す
なおせ	治せ 療せ 直せ
なおせる	治せる 直せる
なおそう	治そう 直そう
なおっ	復っ 治っ 癒っ 直っ
なおら	復ら 治ら 癒ら 直ら
なおり	治り 癒り 直り
なおりかけ	治りかけ 治り掛け
なおる	復る 治る 癒る 直る
なおれ	治れ 直れ
なか	哭か 啼か 泣か 鳴か
なかし	泣かし 鳴かし 鳴し
なかす	泣かす 鳴かす
なが	和が 薙が
ながしあう	流しあう 流し合う
ながしあっ	流しあっ 流し合っ
ながしいれ	流しいれ 流し入れ
ながしこま	流しこま 流し込ま
ながしこみ	流しこみ 流し込み
ながしこむ	流しこむ 流し込む
ながしこめ	流しこめ 流し込め
ながしこもう	流しこもう 流し込もう
ながしこん	流しこん 流し込ん
ながびい	長びい 長引い
ながびき	長びき 長引き
ながびく	長びく 長引く
ながめまわし	眺めまわし 眺め回し
ながめまわす	眺めまわす 眺め回す
ながらえ	存え 永らえ 長らえ
ながらえる	存える 永らえる 長らえる
ながれあるい	流れあるい 流れ歩い
ながれおり	流れおり 流れ下り 流れ降り
ながれおりる	流れ降りる 流れ降る
ながれき	流れき 流れ来
ながれくだっ	流れくだっ 流れ下っ
ながれくだり	流れくだり 流れ下り
ながれくる	流れくる 流れ来る
ながれこま	流れこま 流れ込ま
ながれこみ	流れこみ 流れ込み
ながれこむ	流れこむ 流れ込む
ながれこん	流れこん 流れ込ん
ながれだし	流れだし 流れ出し
ながれだす	流れだす 流れ出す
ながれつい	流れ付い 流れ着い
ながれで	流れで 流れ出
なき	号き 哭き 啼き 泣き 鳴き
なきあう	泣き合う 鳴き合う
なきあかし	泣きあかし 泣き明かし
なきおとし	泣きおとし 泣き落とし
なきくずれる	泣きくずれる 泣き崩れる
なきさけび	哭き叫び 泣き叫び 鳴き叫び
なきさけぶ	泣きさけぶ 泣き叫ぶ 鳴き叫ぶ
なきさけん	泣き叫ん 泣叫ん 鳴き叫ん
なきさわぐ	泣き騒ぐ 鳴き騒ぐ
なきすがる	泣きすがる 泣き縋る
なきたてる	泣き立てる 鳴き立てる
なきつい	泣きつい 泣き付い 泣付い
なきつか	泣きつか 泣き付か
なきつかれ	泣き疲れ 鳴き疲れ
なきつき	泣きつき 泣き付き
なきぬれ	泣きぬれ 泣き濡れ
なきぬれる	泣きぬれる 泣き濡れる
なきはらし	泣きはらし 泣き腫らし
なきやま	泣きやま 泣き止ま 鳴きやま
なきやみ	泣きやみ 泣き止み 鳴きやみ
なきやむ	哭きやむ 泣き止む 鳴きやむ 鳴き止む
なきやん	泣きやん 泣き止ん
なきわめい	泣きわめい 泣き喚い 鳴きわめい
なきわめき	泣きわめき 泣き喚き 鳴き喚き
なきわめく	泣きわめく 泣き喚く 鳴きわめく
なぎ	凪ぎ 和ぎ 薙ぎ
なぎたおさ	なぎ倒さ 薙ぎ倒さ
なぎたおし	なぎ倒し 薙ぎ倒し 薙倒し
なぎたおす	なぎ倒す 薙ぎ倒す 薙倒す
なぎはらい	なぎ払い 薙ぎ払い
なぎはらう	なぎ払う 薙ぎ払う 薙払う
なぎはらっ	なぎ払っ 薙ぎ払っ
なぎはらわ	なぎ払わ 薙ぎ払わ
なく	号く 哭く 啼く 泣く 鳴く
なくさ	亡くさ 亡さ 失くさ 無くさ
なくし	亡くし 亡し 喪くし 失くし 無くし
なくす	亡くす 亡す 失くす 無くす
なくする	亡くする 無くする
なくせ	亡くせ 無くせ
なくそ	亡くそ 無くそ
なくそう	失くそう 無くそう
なくなっ	亡くなっ 亡なっ 失くなっ 歿くなっ 没くなっ 無くなっ
なくなら	亡くなら 歿くなら 無くなら
なくなり	亡くなり 失くなり 無くなり 無なり
なくなる	亡くなる 失くなる 無くなる 無なる
なくなれ	亡くなれ 無くなれ
なくなろう	亡くなろう 無くなろう
なぐ	凪ぐ 和ぐ 薙ぐ
なぐさめあい	慰めあい 慰め合い
なぐさめあう	慰めあう 慰め合う
なぐさめあっ	慰めあっ 慰め合っ
なぐさめる	慰さめる 慰める
なぐっ	擲っ 殴っ
なぐら	撲ら 殴ら
なぐり	撲り 殴り
なぐりあい	殴りあい 殴り合い
なぐりあう	殴りあう 殴り合う
なぐりあっ	殴りあっ 殴り合っ
なぐりあわ	殴りあわ 殴り合わ
なぐりかかっ	殴りかかっ 殴り掛かっ
なぐりかから	殴りかから 殴り掛から
なぐりかかり	殴りかかり 殴り掛かり
なぐりかかる	殴りかかる 殴り掛かる
なぐりかかろう	殴りかかろう 殴り掛かろう
なぐりたおさ	なぐり倒さ 殴り倒さ
なぐりたおし	殴りたおし 殴り倒し
なぐりたおす	なぐり倒す 殴り倒す
なぐりたおせ	殴りたおせ 殴り倒せ
なぐりつけ	撲りつけ 殴りつけ 殴り付け
なぐりつける	殴りつける 殴り付ける
なぐる	ナグる 撲る 擲る 殴る
なけ	号け 哭け 啼け 泣け 鳴け
なける	泣ける 鳴ける
なげ	投 投げ 抛げ
なげい	哭い 嘆い 歎い
なげいれ	投げいれ 投げ入れ
なげいれる	投げいれる 投げ入れる
なげうた	投げうた 投げ打た
なげうち	投げうち 投げ打ち 抛ち 擲ち
なげうっ	投げうっ 投げ売っ 投げ打っ 擲っ
なげうつ	投げうつ 投げ打つ 抛つ 擲つ
なげうて	投げうて 投げ打て 抛て 擲て
なげおとさ	投げ落さ 投げ落とさ
なげおとし	投げ落し 投げ落とし
なげおとす	投げ落す 投げ落とす
なげか	哭か 嘆か 歎か
なげかえさ	投げかえさ 投げ返さ
なげかえし	投げかえし 投げ返し
なげかけ	投げかけ 投げ掛け
なげかける	投げかける 投げ掛ける
なげき	哭き 嘆き 歎き
なげきかなしみ	嘆き悲しみ 歎き悲しみ
なげきかなしむ	嘆き悲しむ 歎き悲しむ
なげきかなしん	なげき悲しん 嘆きかなしん 嘆き悲しん
なげく	哭く 嘆く 歎く
なげけ	哭け 嘆け
なげこま	投げこま 投げ込ま 投込ま
なげこみ	投げこみ 投げ込み 投込み
なげこむ	投げこむ 投げ込む
なげこもう	投げこもう 投げ込もう
なげこん	投げこん 投げ込ん
なげすて	なげ捨て 投げすて 投げ捨て 投げ棄て 投捨て
なげすてよ	投げすてよ 投げ捨てよ
なげすてよう	投げ捨てよう 投げ棄てよう
なげすてる	投げすてる 投げ捨てる 投げ棄てる
なげださ	投げださ 投げ出さ 投出さ
なげだし	投げだし 投げ出し 投出し
なげだす	投げだす 投げ出す
なげだそう	投げだそう 投げ出そう
なげつけ	投げつけ 投げ付け 投付け
なげつける	投げつける 投げ付ける
なげとばす	投げとばす 投げ飛ばす
なこう	泣こう 鳴こう
なさ	作さ 成さ 済さ 濟さ 為さ 爲さ 生さ
なし	作し 成し 済し 為し 爲し
なしとげ	なし遂げ 成しとげ 成し遂げ 為しとげ 為し遂げ
なしとげよう	なし遂げよう 成しとげよう 成し遂げよう
なしとげる	なし遂げる 成しとげる 成し遂げる 為しとげる 為し遂げる
なじめ	馴染 馴染め
なす	作す 成す 済す 為す 爲す 生す
なすりあい	なすり合い 擦り合い
なすりあう	なすり合う 擦り合う
なずらえ	准え 擬え 準え
なせ	作せ 成せ 為せ 生せ
なせる	成せる 為せる 生せる
なせん	成せん 為せん
なそう	成そう 為そう
なぞらえ	准え 擬え 準え
なぞらえる	擬える 準える
なだめすかし	宥めすかし 宥め賺し
なだれ	傾れ 雪崩れ
なだれこま	なだれ込ま 雪崩れ込ま
なだれこみ	なだれ込み 傾れ込み 雪崩れ込み 雪崩込み
なだれこむ	なだれ込む 雪崩れ込む 雪崩込む
なだれこもう	なだれ込もう 雪崩れ込もう
なだれこん	なだれ込ん 傾れ込ん 雪崩れ込ん 雪崩込ん
なっ	なッ 成っ 為っ 生っ 綯っ 鳴っ
なつかしむ	懐かしむ 懐しむ
なづけ	名け 名づけ 名付 名付け
なづけよ	名づけよ 名付けよ
なづけよう	名づけよう 名付けよう
なづける	名づける 名付ける 名付る
なであげ	なで上げ 撫で上げ
なであげる	なで上げる 撫で上げる
なでおろし	なで下ろし 撫でおろし 撫で下ろし
なでおろす	なで下ろす 撫でおろす 撫で下ろす
なでつけ	撫でつけ 撫で付け
なでつける	なで付ける 撫でつける
なでまわし	なで回し 撫でまわし 撫で回し
なでまわす	なで回す 撫で回す
なのっ	名っ 名のっ 名乗っ 名告っ
なのら	名のら 名ら 名乗ら
なのり	名のり 名り 名乗り 名告り
なのりで	名のり出 名乗り出
なのりでる	名のり出る 名乗り出る
なのる	名のる 名る 名乗る 名告る
なのれ	名のれ 名乗れ
なのろう	名のろう 名乗ろう
なぶりころさ	なぶり殺さ 嬲り殺さ
なぶりころし	なぶり殺し 嬲り殺し
なまけ	怠け 懶け
なまら	ナマら 訛ら
なまる	ナマる 訛る
なみいる	並みいる 並み居る 並居る
なみうち	波うち 波打ち
なみうっ	波うっ 波打っ
なみうつ	波うつ 波打つ
なみし	無みし 蔑し
なみだっ	波だっ 波立っ
なみはずれ	並はずれ 並み外れ 並外れ
なめ	嘗め 舐め
なめあい	なめ合い 嘗め合い 舐め合い
なめあう	なめ合う 嘗め合う 舐め合う
なめとり	舐めとり 舐め取り
なめとる	嘗め取る 舐めとる 舐め取る
なめまわし	なめ回し 嘗め回し 舐めまわし 舐め回し 舐め廻し
なめまわす	なめ回す 嘗め回す 舐めまわす 舐め回す
なめる	ナメる 嘗める 舐める
なめろ	嘗めろ 舐めろ
なめん	ナメん 舐めん
なやま	悩ま 惱ま
なやまさ	悩さ 悩まさ 惱まさ
なやみ	悩み 惱み
なやみくるしむ	なやみ苦しむ 悩み苦しむ
なやみぬい	悩みぬい 悩み抜い
なやみぬき	悩みぬき 悩み抜き
なやめ	悩め 惱め
なら	成ら 為ら 生ら 鳴ら
ならい	倣い 習い 習らい
ならいおぼえ	習いおぼえ 習い覚え
ならう	倣う 傚う 習う
ならえ	倣え 準え 習え
ならおう	倣おう 習おう
ならさ	均さ 慣らさ 馴らさ 鳴さ 鳴らさ
ならし	均し 均らし 慣し 慣らし 成らし 馴し 馴らし 鳴らし
ならす	均す 慣らす 成らす 生らす 馴らす 鳴す 鳴らす
ならせ	均せ 慣らせ 馴らせ 鳴せ 鳴らせ
ならそう	均そう 慣らそう 鳴らそう
ならっ	倣っ 傚っ 習っ
ならば	並ば 列ば
ならび	並び 併び 列び 双び 竝び 雙び
ならびかえ	並びかえ 並び換え 並び替え
ならびかえる	並び換える 並び替える
ならびたち	並び建ち 並び立ち
ならびたっ	並び建っ 並び立っ
ならびたつ	並び建つ 並び立つ
ならびたて	並び建て 並び立て
ならぶ	並ぶ 列ぶ 双ぶ 陳ぶ
ならべ	並 並べ 並らべ 列べ 双べ 陳べ
ならべあげ	並べ上げ 並べ挙げ
ならべあげる	並べ上げる 並べ挙げる
ならべかえ	並べかえ 並べ変え 並べ換え 並べ替え
ならべかえる	並べかえる 並べ変える 並べ換える 並べ替える
ならべかえれ	並べ変えれ 並べ替えれ
ならべたて	並べたて 並べ立 並べ立て
ならべたてる	並べたてる 並べ立てる
ならべなおし	ならべ直し 並べなおし 並べ直し
ならべなおす	ならべ直す 並べなおす 並べ直す
ならべる	並べる 列べる
ならわ	倣わ 習わ
ならわさ	慣わさ 習わさ
ならわし	慣わし 習わし
ならわす	慣わす 習わす
ならん	並ん 列ん 竝ん
なり	成り 為り 生り 鳴り
なりあがっ	成りあがっ 成り上がっ
なりあがら	成りあがら 成り上がら
なりあがり	成りあがり 成り上がり 成り上り
なりあがる	成りあがる 成り上がる
なりあがれる	成りあがれる 成り上がれる
なりあがろう	成り上がろう 成り上ろう
なりかわっ	なり代わっ なり変わっ 成り代っ 成り代わっ 成り変わっ 成り替わっ
なりかわら	成り代わら 成り変わら
なりかわり	なり代わり なり変わり 成り代り 成り代わり 成り変わり 成り替わり
なりかわる	なり変わる 成り代わる 成り変わる 成り替わる
なりさがっ	なり下がっ なり下っ 成り下がっ
なりさがり	なり下がり 成りさがり 成り下がり
なりさがる	なり下がる 成り下がる
なりすまさ	成りすまさ 成り済まさ
なりすまし	成りすまし 成り済まし
なりすます	成りすます 成り済ます
なりたた	成りたた 成り立た 成立た
なりたち	なり立ち 成りたち 成り立ち 成立ち
なりたっ	成りたっ 成り立っ 成立っ
なりたつ	なり立つ 成りたつ 成り立つ 成立つ
なりひびい	鳴りひびい 鳴り響い 鳴響い
なりひびか	鳴りひびか 鳴り響か
なりひびき	鳴りひびき 鳴り響き 鳴響き
なりひびく	なり響く 鳴りひびく 鳴り響く 鳴響く
なりやま	鳴りやま 鳴り止ま
なりやみ	鳴りやみ 鳴り止み
なりやむ	鳴りやむ 鳴り止む
なりやん	鳴りやん 鳴り止ん
なる	成る 為る 生る 鳴る
なれ	慣れ 成れ 為れ 熟れ 狎れ 馴れ 鳴れ
なれあい	なれ合い 慣れ合い 馴れ合い
なれあう	なれ合う 慣れ合う 馴れ合う
なれあっ	なれ合っ 馴れ合っ
なれしたしま	慣れ親しま 馴れ親しま
なれしたしみ	慣れ親しみ 馴れ親しみ
なれしたしん	なれ親しん 慣れ親しん 馴れ親しん
なれる	慣れる 成れる 熟れる 狎れる 馴れる
なれれ	慣れれ 成れれ
なろう	倣う 成ろう 習う 鳴ろう
なろふ	倣ふ 傚ふ 習ふ
に	似 烹 煮 肖
にあがっ	煮あがっ 煮上がっ
にあがる	煮あがる 煮上がる
にあわ	似あわ 似合わ
にえくり	煮えくり 煮え繰り
にえたぎる	煮えたぎる 煮え滾る
にえたっ	煮えたっ 煮え立っ
におい	匂い 臭い
においたつ	匂いたつ 匂い立つ
におう	匂う 臭う 香う
におっ	匂っ 香っ
におふ	匂ふ 香ふ
におわ	匂わ 臭わ
におわさ	匂わさ 臭わさ
におわし	匂わし 臭わし
におわす	匂わす 臭わす
にかえし	煮かえし 煮返し
にかよい	似かよい 似通い
にかよっ	似かよっ 似通っ
にかよわ	似かよわ 似通わ
にがみばしっ	苦みばしっ 苦み走っ 苦味走っ
にきり	煮きり 煮切り
にぎっ	掴っ 握っ
にぎら	掴ら 握ら
にぎり	掴り 握り
にぎりあう	握りあう 握り合う
にぎりあっ	握りあっ 握り合っ
にぎりかえる	握り変える 握り替える
にぎりこま	握りこま 握り込ま
にぎりこむ	握りこむ 握り込む
にぎりこん	握りこん 握り込ん
にぎりしめ	握りしめ 握り締め
にぎりしめる	握りしめる 握り締める
にぎりつぶさ	握りつぶさ 握り潰さ
にぎりつぶし	握りつぶし 握り潰し
にぎりつぶす	握りつぶす 握り潰す
にぎりつぶせ	握りつぶせ 握り潰せ
にぎりつぶせる	握りつぶせる 握り潰せる
にぎりつぶそう	握りつぶそう 握り潰そう
にぎわい	賑い 賑わい
にぎわう	賑う 賑わう
にぎわっ	賑っ 賑わっ
にぎわわ	賑わ 賑わわ
にくま	悪ま 憎ま
にくみ	悪み 憎み
にくみあい	憎みあい 憎み合い
にくみあう	憎みあう 憎み合う
にくみあっ	憎みあっ 憎み合っ
にくむ	悪む 憎む
にくめ	ニクめ 憎め
にくん	悪ん 憎ん
にげ	逃 逃げ 遁げ
にげかえっ	逃げかえっ 逃げ帰っ
にげかえり	逃げかえり 逃げ帰り
にげこみ	逃げこみ 逃げ込み
にげこむ	逃げこむ 逃げ込む
にげこもう	逃げこもう 逃げ込もう
にげこん	逃げこん 逃げ込ん 逃込ん
にげさっ	逃げさっ 逃げ去っ
にげさる	逃げさる 逃げ去る
にげださ	逃げださ 逃げ出さ
にげだし	逃げだし 逃げ出し
にげだす	逃げだす 逃げ出す 逃出す
にげだせ	逃げだせ 逃げ出せ
にげだせる	逃げだせる 逃げ出せる
にげだそう	逃げだそう 逃げ出そう
にげつぶれ	逃げつぶれ 逃げ潰れ
にげのび	逃げのび 逃げ延び
にげのびよう	逃げのびよう 逃げ延びよう
にげのびる	逃げのびる 逃げ延びる
にげのぼっ	逃げ上っ 逃げ登っ
にげまどい	逃げまどい 逃げ惑い
にげまどう	逃げまどう 逃げ惑う
にげまどっ	逃げまどっ 逃げ惑っ
にげまわっ	逃げまわっ 逃げ回っ
にげまわら	逃げまわら 逃げ回ら
にげまわり	逃げまわり 逃げ回り
にげまわる	逃げまわる 逃げ回る
にげもどり	逃げもどり 逃げ戻り
にげる	逃げる 逃る
にげろ	逃げろ 遁げろ
にこみ	煮こみ 煮込み
にこむ	煮こむ 煮込む
にこん	煮こん 煮込ん
にしめ	煮しめ 煮染め 煮締め
にしめる	煮しめる 煮染める
にじみ	渗み 滲み
にじみださ	にじみ出さ 滲み出さ
にじみだし	にじみ出し 滲みだし 滲み出し
にじみだす	にじみ出す 滲みだす 滲み出す
にじみで	にじみ出 滲み出
にじみでる	にじみ出る 滲み出る
にじりよっ	にじり寄っ 躙り寄っ
にたっ	煮たっ 煮立っ
にたて	煮たて 煮立て
にたてる	煮たてる 煮立てる
にだし	煮だし 煮出し
につか	似つか 似付か
につけ	煮つけ 煮付け
につまっ	煮つまっ 煮詰まっ
につまる	煮つまる 煮詰まる 煮詰る
につめ	煮つめ 煮詰め
につめる	煮つめる 煮詰める
にとかし	煮とかし 煮溶かし
にない	担い 荷い
になう	担う 荷う 荷なう
になえ	担え 荷え
になっ	担っ 荷っ 荷なっ
によう	似よう 煮よう
にらみあい	にらみ合い 睨みあい 睨み合い
にらみあう	にらみ合う 睨みあう 睨み合う
にらみあっ	にらみ合っ 睨みあっ 睨み合っ
にらみあわせ	にらみ合わせ 睨み合わせ
にらみかえし	にらみ返し 睨み返し
にらみかえす	にらみ返す 睨み返す
にらみすえる	睨みすえる 睨み据える
にらみつけ	にらみ付け 睨みつけ 睨み付け
にらみつける	にらみ付ける 睨みつける 睨み付ける
にる	似る 烹る 煮る
にん	似ん 煮ん
ぬい	抜い 拔い 縫い 脱い
ぬいあわせ	縫いあわせ 縫い合せ 縫い合わせ
ぬいあわせる	縫いあわせる 縫い合わせる
ぬいこま	縫いこま 縫い込ま
ぬいこむ	縫いこむ 縫い込む
ぬいこん	縫いこん 縫い込ん
ぬいつけ	縫いつけ 縫い付け
ぬいつける	縫いつける 縫い付ける
ぬいとめ	縫いとめ 縫い止め 縫い留め
ぬいとめる	縫いとめる 縫い止める 縫い留める
ぬいとら	縫いとら 縫い取ら
ぬいとり	縫いとり 縫い取り
ぬか	抜か 拔か
ぬかさ	吐かさ 抜かさ
ぬかし	吐し 抜かし
ぬかす	吐かす 抜かす
ぬかずく	額ずく 額衝く
ぬきあわせ	抜きあわせ 抜き合わせ
ぬきださ	抜きださ 抜き出さ
ぬきだし	抜きだし 抜き出し
ぬきだす	ぬき出す 抜きだす 抜き出す
ぬきとっ	抜きとっ 抜き取っ 抜取っ
ぬきとら	抜きとら 抜き取ら
ぬきとり	抜きとり 抜き取り 抜取り
ぬきとる	抜きとる 抜き取る
ぬきはなち	抜きはなち 抜き放ち
ぬきんで	抜きんで 抜きん出 擢んで
ぬきんでる	抜きんでる 抜きん出る
ぬぎすて	ぬぎ捨て 脱ぎすて 脱ぎ捨て 脱ぎ棄て
ぬぎすてる	脱ぎすてる 脱ぎ捨てる
ぬぐいさっ	ぬぐい去っ 拭い去っ
ぬぐいさら	ぬぐい去ら 拭い去ら
ぬぐいさる	ぬぐい去る 拭い去る
ぬぐいされ	ぬぐい去れ 拭いされ 拭い去れ
ぬぐいさろう	ぬぐい去ろう 拭い去ろう
ぬぐいとっ	ぬぐい取っ 拭い取っ
ぬぐいとる	ぬぐい取る 拭い取る
ぬぐえ	拭 拭え
ぬけ	抜 抜け 拔け 脱け
ぬけあがり	抜けあがり 抜け上がり
ぬけおち	ぬけ落ち 抜けおち 抜け落ち 脱け落ち
ぬけおちる	抜けおちる 抜け落ちる
ぬけかわら	抜け変わら 抜け替わら
ぬけかわり	抜けかわり 抜け代わり 抜け替わり
ぬけださ	抜け出さ 脱け出さ
ぬけだし	ぬけ出し 抜け出し 抜出し 脱けだし 脱け出し
ぬけだす	ぬけ出す 抜け出す 脱け出す
ぬけだせ	抜け出せ 脱け出せ
ぬけだそう	抜け出そう 脱け出そう
ぬけで	抜けで 抜け出 抜出 脱け出
ぬけでる	抜け出る 脱け出る
ぬける	ヌケる 抜ける
ぬげ	脱 脱げ
ぬげる	脱げる 脱る
ぬすみ	偸み 盗み
ぬすみださ	ぬすみ出さ 盗みださ 盗み出さ
ぬすみだし	ぬすみ出し 盗みだし 盗み出し
ぬすみだす	盗みだす 盗み出す
ぬすみとっ	盗みとっ 盗み取っ
ぬすみとら	盗みとら 盗み取ら
ぬすみとる	盗みとる 盗み取る
ぬすみとろう	盗みとろう 盗み取ろう
ぬすむ	偸む 盗む
ぬっ	塗っ 縫っ
ぬら	ヌら 塗ら
ぬりかえ	ぬり変え 塗りかえ 塗り変え 塗り換え 塗り替え
ぬりかえよう	塗り変えよう 塗り替えよう
ぬりかえる	塗りかえる 塗り変える 塗り替える
ぬりかさねる	塗りかさねる 塗り重ねる
ぬりかため	塗りかため 塗り固め
ぬりかわっ	塗り変わっ 塗り替わっ
ぬりかわり	塗り変わり 塗り替わり
ぬりかわる	塗り変わる 塗り替わる
ぬりこま	塗りこま 塗り込ま
ぬりこみ	塗りこみ 塗り込み
ぬりこむ	塗りこむ 塗り込む
ぬりこめ	塗りこめ 塗り籠め 塗り込め
ぬりこめる	塗りこめる 塗り籠める 塗り込める
ぬりこん	塗りこん 塗り込ん
ぬりつけ	塗りつけ 塗り付け 塗付け
ぬりつける	塗りつける 塗り付ける
ぬりつぶさ	塗りつぶさ 塗り潰さ
ぬりつぶし	塗りつぶし 塗り潰し 塗潰し
ぬりつぶす	塗りつぶす 塗り潰す
ぬりつぶせ	塗りつぶせ 塗り潰せ
ぬりなおさ	塗りなおさ 塗り直さ
ぬりなおし	塗りなおし 塗り直し
ぬりなおす	塗りなおす 塗り直す
ぬりわけ	ぬり分け 塗りわけ 塗り分け
ぬりわける	塗りわける 塗り分ける
ぬれ	塗れ 濡れ
ぬれる	ヌレる 塗れる 濡れる
ね	寝 寢
ねかしつけ	寝かしつけ 寝かし付け
ねかしつける	寝かしつける 寝かし付ける
ねがい	希い 願い
ねがいで	願いで 願い出
ねがいでる	願いでる 願い出る
ねがう	希う 願う
ねがえる	寝返る 願える
ねがっ	希っ 願っ
ねこみ	寝こみ 寝込み
ねころがっ	寝ころがっ 寝転がっ
ねころがる	寝ころがる 寝転がる
ねころび	寝ころび 寝転び
ねころぶ	寝ころぶ 寝転ぶ
ねころん	寝ころん 寝転ん
ねこん	寝こん 寝込ん
ねごふ	希ふ 願ふ
ねざさ	根ざさ 根差さ
ねざし	根ざし 根差し
ねざす	根ざす 根差す
ねじあげ	ねじ上げ 捻じ上げ
ねじきら	ねじ切ら 捩じ切ら 捻じ切ら
ねじきり	ねじ切り 捩じ切り
ねじきる	ねじ切る 捩じ切る 捻じ切る
ねじきれ	ねじ切れ 捩じ切れ
ねじこま	ねじ込ま 捻じ込ま
ねじこみ	ねじ込み 捩じ込み 捻じ込み
ねじこむ	ねじ込む 捩じ込む
ねじこん	ねじ込ん 捩じ込ん 捻じ込ん
ねじっ	ネジっ 捩じっ 捻じっ
ねじふせ	ねじ伏せ 捩じ伏せ 捻じ伏せ
ねじふせる	ねじ伏せる 捩じ伏せる 捻じ伏せる
ねじまがっ	ねじ曲がっ 捻じ曲がっ
ねじまがり	ねじ曲がり 捻じ曲がり
ねじまがる	ねじ曲がる 捻じ曲がる
ねじまげ	ねじ曲げ 捩じ曲げ 捻じ曲げ
ねじまげよう	ねじ曲げよう 捻じ曲げよう
ねじまげる	ねじ曲げる 捩じ曲げる 捻じ曲げる
ねじら	捩じら 捻じら
ねじり	捩じり 捻じり
ねじる	ネジる 捩じる 捻じる
ねじれ	捩じれ 捻じれ 捻れ
ねじれる	ネジれる 捻じれる 捻れる
ねっ	弥っ 練っ
ねつい	寝つい 寝付い
ねつか	寝つか 寝付か
ねつく	寝つく 寝付く
ねつけ	寝つけ 寝付け
ねづい	根づい 根付い
ねづか	根づか 根付か
ねづき	根づき 根付き
ねづく	根づく 根付く
ねづけ	根づけ 根付け
ねづこう	根づこう 根付こう
ねとっ	寝とっ 寝取っ 寝盗っ
ねとら	寝とら 寝取ら 寝盗ら
ねとり	寝取り 寝盗り
ねとる	寝とる 寝取る
ねばりつい	粘りつい 粘り付い 粘り着い
ねばりつき	粘りつき 粘り着き
ねばりつく	粘りつく 粘り着く
ねばりつけ	粘りつけ 粘り着け
ねぼけ	寝ぼけ 寝呆け 寝惚
ねむっ	眠っ 睡っ
ねむら	眠ら 睡ら
ねむり	眠り 睡り
ねむりこむ	眠りこむ 眠り込む
ねむりこん	眠りこん 眠り込ん
ねむる	眠る 睡る
ねむれ	眠れ 睡れ
ねむれる	眠れる 睡れる
ねら	弥ら 練ら 錬ら
ねらいうた	狙い打た 狙い撃た
ねらいうち	ねらい打ち 狙い打ち 狙い撃ち
ねらいうっ	ねらい撃っ 狙い打っ 狙い撃っ
ねらいうつ	ねらい打つ ねらい撃つ 狙い打つ 狙い撃つ
ねらいすまし	狙いすまし 狙い澄まし
ねり	煉り 練り 錬り
ねりあげ	ねり上げ 練りあげ 練り上げ 練上げ
ねりあるい	ねり歩い 練り歩い
ねりあるき	ねり歩き 練り歩き
ねりあるく	ねり歩く 練りあるく 練り歩く 練歩く
ねりあわせ	練りあわせ 練り合せ 練り合わせ
ねりこま	練りこま 練り込ま
ねりこみ	練りこみ 練り込み
ねりこむ	練りこむ 練り込む
ねりこめ	練りこめ 練り込め
ねりこん	練りこん 練り込ん
ねりなおし	練り直し 練直し
ねる	寝る 煉る 練る 錬る
ねれ	寝れ 練れ
ねれる	寝れる 練れる
ねんじ	念じ 拈じ
のがさ	逃さ 遁さ
のがす	逃す 遁す
のがれ	脱れ 逃がれ 逃れ 遁れ
のがれで	逃がれ出 逃れ出
のがれよう	逃がれよう 逃れよう
のがれる	脱れる 逃がれる 逃れる 遁れる
のけぞっ	のけ反っ 仰け反っ
のけぞら	のけ反ら 仰け反ら
のけぞり	のけ反り 仰け反り
のけぞる	のけ反る 仰け反る
のこさ	残さ 遺さ
のこし	残し 貽し 遺し
のこす	残す 殘す 貽す 遺す
のこせ	残せ 殘せ 遺せ
のこせる	残せる 遺せる
のこそう	残そう 遺そう
のこっ	残っ 遺っ
のこら	残ら 殘ら
のこり	残り 遺り
のこる	残る 遺る
のこれ	残れ 遺れ
のし	乗し 伸し 搭し 載し
のしあがっ	のし上がっ のし上っ 伸し上がっ
のしあがり	のし上がり のし上り 伸し上がり
のしあがる	のし上がる 伸し上がる
のしあがろう	のし上がろう 伸し上がろう
のしあげ	のし上げ 伸し上げ
のしあげる	のし上げる 伸し上げる
のしかかっ	のし掛かっ 伸し掛かっ 伸し掛っ
のしかかり	のし掛かり 伸し掛かり
のしかかる	のし掛かる 伸し掛る
のせ	乗せ 伸せ 搭せ 載せ
のせかえ	乗せかえ 乗せ変え 乗せ替え 載せ変え 載せ換え 載せ替え
のせかえる	乗せかえる 乗せ変える 乗せ替える 載せ換える 載せ替える
のせよう	乗せよう 載せよう
のせる	乗せる 載せる
のせれ	乗せれ 載せれ
のせろ	乗せろ 載せろ
のぞい	ノゾい 窺い 覗い 除い
のぞか	覗か 除か
のぞき	ノゾき 覗き 覘き 除き
のぞきこま	のぞき込ま 覗きこま 覗き込ま
のぞきこみ	のぞき込み 覗きこみ 覗き込み
のぞきこむ	のぞき込む 覗きこむ 覗き込む
のぞきこめ	のぞき込め 覗き込め
のぞきこめる	のぞき込める 覗き込める
のぞきこん	のぞき込ん 覗きこん 覗き込ん
のぞきみ	のぞき見 覗き見
のぞきみえる	のぞき見える 覗き見える
のぞきみる	のぞき見る 覗き見る
のぞく	ノゾく 覗く 除く
のぞけ	覗け 覘け 除け
のぞける	覗ける 除ける
のぞこう	覗こう 除こう
のぞま	望ま 臨ま
のぞみ	希み 望み 臨み
のぞむ	希む 望む 臨む
のぞめ	望め 臨め
のぞめよ	望めよ 臨めよ
のぞめる	望める 臨める
のぞもう	望もう 臨もう
のぞん	希ん 望ん 臨ん
のたまい	宣い 曰い
のたまう	宣う 宣まう 曰う
のたまふ	曰 曰ふ
のたまわ	宣わ 曰わ
のたれじぬ	のたれ死ぬ 野垂れ死ぬ
のたれじん	のたれ死ん 野垂れ死ん
のっ	ノっ 乗っ 載っ
のっかっ	乗っかっ 載っかっ
のっかり	乗っかり 載っかり
のっけ	乗っけ 載っけ
のっとっ	乗っとっ 乗っ取っ 乗取っ 則っ 法っ
のっとら	乗っとら 乗っ取ら 則ら 法ら
のっとり	乗っとり 乗っ取り 乗取り 則り 法り
のっとる	乗っとる 乗っ取る 則る 法る
のっとれ	乗っとれ 乗っ取れ 則れ
のっとろう	乗っとろう 乗っ取ろう 乗取ろう
ののしら	罵しら 罵ら
ののしり	罵しり 罵り
ののしりあい	ののしり合い 罵り合い
ののしりあう	ののしり合う 罵り合う
ののしる	罵しる 罵る
のばさ	伸さ 伸ばさ 延さ 延ばさ
のばし	伸ばし 延し 延ばし
のばす	伸す 伸ばす 延す 延ばす
のばせ	伸ばせ 延ばせ
のばせる	伸ばせる 延ばせる
のばそう	伸ばそう 延ばそう
のび	伸び 延び 暢び
のびあがっ	伸びあがっ 伸び上がっ 延び上がっ
のびあがり	伸びあがり 伸び上がり 伸上り
のびあがる	伸びあがる 伸び上がる
のびひろがる	伸び広がる 延び広がる
のびよう	伸びよう 延びよう
のびる	ノビる 伸びる 延びる
のべ	伸べ 叙べ 宣べ 展べ 延べ 述べ 陳べ
のべあい	述べあい 述べ合い
のべあう	述べあう 述べ合う
のべあっ	述べあっ 述べ合っ
のべたて	述べたて 述べ立て
のべたてる	述べたてる 述べ立てる
のべつたえ	宣べ伝え 述べ伝え
のべつたえる	宣べ伝える 述べ伝える
のべよう	述べよう 陳べよう
のべる	伸べる 宣べる 延べる 述べる 陳べる
のぼせ	上せ 逆上 逆上せ
のぼせあがり	のぼせ上がり のぼせ上り
のぼせる	上せる 逆上る
のぼっ	上っ 攀っ 昇っ 登っ
のぼら	上ら 攀ら 昇ら 登ら
のぼり	上り 攀り 昇り 登り
のぼりつめ	のぼり詰め 上りつめ 上り詰め 昇りつめ 昇り詰め 登りつめ 登り詰め
のぼりつめよう	昇りつめよう 登り詰めよう
のぼりつめる	のぼり詰める 上りつめる 上り詰める 昇りつめる 昇り詰める 登りつめる 登り詰める
のぼる	上る 昇る 登る
のぼれ	上れ 昇れ 登れ
のぼれる	上れる 昇れる 登れる
のぼろう	上ろう 昇ろう 登ろう
のま	吞ま 呑ま 喫ま 飮ま 飲ま
のまさ	呑まさ 飲まさ
のまし	呑まし 飲し 飲まし
のます	呑ます 飲す 飲ます
のまそう	呑まそう 飲まそう
のみ	吞み 呑み 喫み 嚥み 飲み
のみあかし	呑み明かし 飲みあかし 飲み明かし
のみあかす	呑み明かす 飲み明かす
のみかけ	飲みかけ 飲み掛け
のみくださ	のみ下さ 飲み下さ
のみくだし	のみ下し 呑みくだし 呑み下し 嚥下し 飲み下し
のみこま	のみ込ま 吞み込ま 呑みこま 呑み込ま 呑込ま 飲みこま 飲み込ま
のみこみ	のみ込み 呑みこみ 呑み込み 飲みこみ 飲み込み 飲込み
のみこむ	のみ込む 吞み込む 呑みこむ 呑み込む 飲みこむ 飲み込む
のみこめ	のみ込め 呑み込め 飲みこめ 飲み込め
のみこめる	呑み込める 飲み込める
のみこもう	のみ込もう 呑みこもう 呑み込もう 飲み込もう
のみこん	のみ込ん 吞み込ん 呑みこん 呑み込ん 飲みこん 飲み込ん
のみたり	呑み足り 飲み足り
のみつぶす	呑みつぶす 飲みつぶす
のみつぶれ	飲みつぶれ 飲み潰れ
のみなおし	飲みなおし 飲み直し
のみなおそう	飲みなおそう 飲み直そう
のみほさ	飲みほさ 飲み干さ
のみほし	飲みほし 飲み干し
のみほす	呑み干す 飲みほす 飲み干す
のみほせる	飲み乾せる 飲み干せる
のみほそう	呑みほそう 飲み干そう
のむ	吞む 呑む 喫む 飲む
のめ	呑め 飲め
のめる	呑める 飲める
のもう	吞もう 呑もう 飲もう
のら	ノら 乗ら 乘ら 伸ら 宣ら 載ら
のり	ノり 乗り 宣り 載り
のりあげ	乗りあげ 乗り上げ 乗り揚げ
のりあげる	乗りあげる 乗り上げる 乗り揚げる
のりあわせ	乗りあわせ 乗り合せ 乗り合わせ 乗合せ
のりいれ	乗りいれ 乗り入れ 乗入れ
のりいれる	乗り入れる 乗入れる
のりうつっ	乗りうつっ 乗り移っ
のりうつる	のり移る 乗り移る
のりかえ	乗りかえ 乗り変え 乗り換え 乗り替え 乗換え
のりかえる	乗りかえる 乗り換える 乗り替える 乗換える
のりかえれ	乗りかえれ 乗り換えれ
のりかかっ	乗りかかっ 乗り掛かっ
のりかかり	乗りかかり 乗り掛かり
のりかかる	乗りかかる 乗り掛かる
のりかわっ	乗り変わっ 乗り替わっ
のりかわり	乗り変わり 乗り替わり
のりかわる	乗り変わる 乗り替わる
のりきっ	乗りきっ 乗り切っ
のりきら	乗りきら 乗り切ら
のりきり	乗りきり 乗り切り 乗切り
のりきる	乗りきる 乗り切る 乗切る
のりきれ	乗りきれ 乗り切れ
のりきれる	乗りきれる 乗り切れる
のりきろう	乗りきろう 乗り切ろう
のりくみ	乗りくみ 乗り組み
のりこえ	のり越え 乗りこえ 乗り超え 乗り越え 乗越え
のりこえよう	乗りこえよう 乗り越えよう
のりこえる	のり超える のり越える 乗りこえる 乗り超える 乗り越える 乗越える
のりこし	乗り越し 乗越し
のりこま	乗りこま 乗り込ま
のりこみ	乗りこみ 乗り込み 乗込み
のりこむ	乗りこむ 乗り込む 乗込む
のりこめ	乗りこめ 乗り込め
のりこもう	乗りこもう 乗り込もう
のりこん	乗りこん 乗り込ん 乗込ん
のりすて	乗り捨て 乗捨て
のりだし	のり出し 乗りだし 乗り出し 乗出し
のりだす	のり出す 乗りだす 乗り出す 乗出す
のりだそう	乗りだそう 乗り出そう
のりつい	乗りつい 乗り継い 乗継い
のりつぎ	乗りつぎ 乗り継ぎ 乗継ぎ
のりつぐ	乗り継ぐ 乗継ぐ
のりつけ	乗りつけ 乗り付け 乗付け
のりつける	乗りつける 乗り付ける
のりつぶし	乗りつぶし 乗り潰し
のりつぶす	乗りつぶす 乗り潰す
のりまわし	乗りまわし 乗り回し 乗り廻し 乗廻し
のりまわす	乗りまわす 乗り回す
のりまわせ	乗りまわせ 乗り回せ
のる	ノる 乗 乗る 乘る 伸る 宣る 載る
のれ	ノれ 乗れ 載れ
のれる	乗れる 載れる
のろい	呪い 詛い
のろう	乗ろう 呪う
のろっ	乗ろっ 呪っ
のろは	呪は 咀は
のん	吞ん 呑ん 喫ん 飲ん
はい	佩い 入 刷い 剥い 匐い 吐い 履い 掃い 矧い 穿い 這い
はいあがっ	はい上がっ 這いあがっ 這い上がっ 這上っ
はいあがり	はい上がり 這いあがり 這い上がり
はいあがる	はい上がる 這いあがる 這い上がる
はいあがろう	はい上がろう 這い上がろう
はいさ	廃さ 拝さ 排さ 配さ
はいし	廃し 廢し 拜し 拝し 排し 配し
はいしよう	廃しよう 拝しよう 配しよう
はいす	廃す 拝す 排す 配す
はいする	廃する 拜する 拝する 排する 配する
はいすれ	廃すれ 配すれ
はいずりまわっ	はいずり回っ 這いずり回っ
はいずりまわる	はいずり回る 這いずり回る
はいせ	廃せ 拜せ 拝せ 排せ 配せ
はいそう	廃そう 拝そう 排そう 配そう
はいだし	はい出し 這いだし 這い出し
はいだす	這いだす 這い出す
はいだせ	はい出せ 這い出せ
はいっ	入っ 這入っ
はいで	はい出 這い出
はいでる	はい出る 這い出る
はいのぼっ	這い上っ 這い昇っ 這い登っ
はいのぼり	這い上り 這い登り
はいのぼる	這いのぼる 這い上る 這い登る
はいまわっ	はい回っ 這いまわっ 這い回っ
はいまわり	はい回り 這いまわり 這い回り
はいまわる	はい回る 這いまわる 這い回る
はいより	這いより 這い寄り
はいよる	這いよる 這い寄る
はいら	入ら 這入ら
はいり	入り 這入り
はいりこま	入りこま 入り込ま
はいりこみ	入りこみ 入り込み
はいりこむ	入りこむ 入り込む
はいりこめ	入りこめ 入り込め
はいりこめる	入りこめる 入り込める
はいりこん	入りこん 入り込ん 這入りこん
はえ	映え 生え 這え
はえかわっ	生えかわっ 生え変わっ 生え替わっ
はえかわら	生えかわら 生え変わら 生え替わら
はえかわり	生えかわり 生え変わり 生え替わり
はえかわる	生えかわる 生え変わる 生え替わる
はえそろい	生えそろい 生え揃い
はえそろう	生えそろう 生え揃う
はえそろっ	生えそろっ 生え揃っ
はえる	映える 生える
はか	佩か 吐か 履か 掃か 穿か
はかっ	図っ 度っ 度ッ 測っ 計っ 諮っ 謀っ 量っ
はから	咨ら 図ら 圖ら 度ら 測ら 計ら 諮ら 謀ら 量ら
はかり	図り 度り 測り 計り 諮り 謀り 量り
はかりしら	はかり知ら 測り知ら 計り知ら
はかりしり	測り知り 量り知り
はかりしる	はかり知る 測り知る 計り知る 量り知る
はかりしれ	はかり知れ 図りしれ 図り知れ 測りしれ 測り知れ 計りしれ 計り知れ 量り知れ
はかりしれる	図り知れる 測り知れる 計り知れる
はかる	図る 測る 計る 諮る 謀る 量る
はかれ	図れ 測れ 計れ 量れ
はかれる	図れる 測れる 計れる 量れる
はかれれ	図れれ 測れれ
はかろう	図ろう 測ろう 計ろう 諮ろう 謀ろう
はがさ	剝がさ 剥がさ 剥さ
はがし	剝がし 剥がし 剥し
はがしとっ	はがし取っ 剥がし取っ
はがしとる	はがし取る 剥がし取る
はがす	剝がす 剥がす 剥す
はがせ	剥がせ 剥せ
はがれ	剝がれ 剥がれ 剥れ
はがれおち	はがれ落ち 剝がれ落ち 剥がれ落ち
はがれおちる	はがれ落ちる 剥がれ落ちる
はき	佩き 刷き 吐き 履き 捌き 掃き 穿き
はきかえ	履きかえ 履き替え 穿き替え
はきかえる	はき換える はき替える 履き替える 穿き替える
はきこみ	はき込み 履き込み
はきすて	はき捨て 吐き捨て 掃き捨て
はきすてる	吐きすてる 吐き捨てる 履き捨てる 掃き捨てる
はきださ	はき出さ 吐きださ 吐き出さ 吐出さ 掃き出さ
はきだし	はき出し 吐きだし 吐き出し 吐出し 掃きだし 掃き出し 掃出し
はきだす	はき出す 吐きだす 吐き出す 掃き出す 掃出す
はきちがえ	はき違え 履き違え
はきつぶし	履きつぶし 履き潰し
はぎ	剝ぎ 剥ぎ 接ぎ 矧ぎ
はぎあわせ	はぎ合わせ 接ぎ合せ
はぎとっ	はぎ取っ 剥ぎとっ 剥ぎ取っ
はぎとら	はぎ取ら 剝ぎ取ら 剥ぎとら 剥ぎ取ら
はぎとり	はぎ取り 剥ぎとり 剥ぎ取り
はぎとる	はぎ取る 剥ぎ取る
はく	佩く 刷く 吐く 履く 捌く 掃く 穿く
はぐ	剥ぐ 接ぐ 矧ぐ
はぐくみ	育くみ 育み
はぐくむ	育くむ 育む
はぐくもう	育くもう 育もう
はぐくん	育くん 育ん
はけ	刷け 吐け 履け 捌け 掃け 穿け
はける	佩ける 吐ける 履ける 捌ける 穿ける
はげ	剝げ 剥げ 禿げ
はげあがっ	はげ上がっ 禿げあがっ 禿げ上がっ
はげあがり	はげ上がり 禿げあがり 禿げ上がり
はげおち	はげ落ち 剝げ落ち 剥げ落ち
はげおちる	はげ落ちる 剥げ落ちる
はげま	ハゲま 励ま
はげまさ	励さ 励まさ
はげまし	励し 励まし
はげましあい	励ましあい 励まし合い
はげましあう	励ましあう 励まし合う
はげましあっ	励ましあっ 励まし合っ
はげる	ハゲる 剥げる 禿げる
はこう	佩こう 吐こう 履こう
はこび	搬び 運こび 運び
はこびあげる	運びあげる 運び上げる
はこびいれ	運びいれ 運び入れ
はこびこま	運びこま 運び込ま
はこびこみ	運びこみ 運び込み
はこびこむ	運びこむ 運び込む
はこびこめ	運びこめ 運び込め
はこびこもう	運びこもう 運び込もう
はこびこん	運びこん 運び込ん
はこぶ	搬ぶ 運ぶ
はさま	ハサま 夾ま 挟ま 挾ま 挿ま 鋏ま
はさまら	介ら 挟まら
はさみ	ハサみ 夾み 挟み 挾み 挿み 鋏み
はさみこま	はさみ込ま 挟みこま 挟み込ま
はさみこみ	はさみ込み 挟みこみ 挟み込み
はさみこむ	はさみ込む 挟みこむ 挟み込む
はさみこん	はさみ込ん 挟みこん 挟み込ん
はさみとる	はさみ取る 挟み取る
はさむ	ハサむ 挟む 挾む 挿む 鋏む
はさめ	挟め 挿め
はさん	ハサん 夾ん 挟ん 挾ん 挿ん 鋏ん
はし	派し 破し
はしっ	奔っ 走っ
はしら	奔ら 走ら
はしり	奔り 疾り 走り
はしりおりる	走り下りる 走り降りる
はしりこま	走りこま 走り込ま
はしりこみ	走りこみ 走り込み
はしりこむ	走りこむ 走り込む
はしりこめ	走りこめ 走り込め
はしりこん	走りこん 走り込ん
はしりさっ	走りさっ 走り去っ
はしりで	走りで 走り出
はしりぬけ	走りぬけ 走り抜け
はしりぬける	走りぬける 走り抜ける
はしりまわっ	走りまわっ 走り回っ 走り廻っ
はしりまわり	走りまわり 走り回り 走り廻り
はしりまわる	走りまわる 走り回る 走り廻る
はしりよっ	走りよっ 走り寄っ
はしりより	走りより 走り寄り
はしりよる	走りよる 走り寄る
はしる	奔る 疾る 走る
はしれ	奔れ 走れ
はしろう	奔ろう 走ろう
はじ	恥じ 愧じ 羞じ 耻じ
はじいっ	恥じいっ 恥じ入っ
はじいり	恥じいり 恥じ入り 恥入り
はじいる	恥じいる 恥じ入る
はじきかえさ	はじき返さ 弾き返さ
はじきかえし	はじき返し 弾き返し
はじきかえす	はじき返す 弾きかえす 弾き返す
はじきださ	はじき出さ 弾き出さ
はじきだし	はじき出し 弾き出し
はじきだす	はじき出す 弾き出す
はじきだせ	はじき出せ 弾き出せ
はじきだせる	はじき出せる 弾き出せる
はじきとばさ	はじき飛ばさ 弾き飛ばさ
はじきとばし	はじき飛ばし 弾き飛ばし
はじきとばす	はじき飛ばす 弾き飛ばす
はじく	弾く 撥く
はじけ	ハジけ 弾け
はじけとび	はじけ飛び 弾け飛び
はじけとぶ	はじけ飛ぶ 弾け飛ぶ
はじけとん	はじけ飛ん 弾け飛ん
はじける	ハジける 弾ける
はじまっ	初まっ 始っ 始まっ
はじまら	始まら 始ら
はじまり	初まり 始まり 始り
はじまる	初まる 始まる 始る
はじまれ	始まれ 始れ
はじめ	初め 創め 始め
はじめよ	初めよ 始めよ
はじめる	初める 創める 始める
はじらい	恥じらい 恥らい
はじらう	恥じらう 恥らう
はじらっ	恥じらっ 恥らっ
はじる	恥じる 愧じる
はする	派する 破する
はずかしめ	恥かしめ 辱かしめ 辱しめ 辱め
はずかしめよう	辱しめよう 辱めよう
はずかしめる	恥ずかしめる 辱める
はずし	ハズし 外し
はずせ	ハズせ 外せ
はずれ	ハズれ 外れ
はずれる	ハズレる 外れる
はずれれ	ハズれれ ハズレれ 外れれ
はせ	挾 派せ 馳せ
はせさんじ	はせ参じ 馳せ参じ 馳参じ
はせさんじよう	はせ参じよう 馳せ参じよう
はせさんじる	はせ参じる 馳せ参じる
はせつけ	馳せつけ 馳せ付け
はせむかい	馳せ向い 馳せ向かい
はせよ	馳せよ 駆せよ
はたきおとし	はたき落し はたき落とし
はたきおとそう	はたき落そう はたき落とそう
はたさ	果さ 果たさ
はたし	果し 果たし
はたす	果す 果たす
はたそう	果そう 果たそう
はたらい	働い 働らい
はたらか	働か 働らか
はたらき	働き 働らき
はたらきかけ	働きかけ 働き掛け
はたらきかける	働きかける 働き掛ける
はたらく	働く 働らく
はたらけ	働 働け
はっ	張っ 貼っ 這っ
はっし	発し 發し
はっする	発する 發する
はっせ	発せ 發せ
はなさ	放さ 話さ 離さ
はなし	放し 話し 離し
はなしあい	話しあい 話し合い 話合い
はなしあう	話しあう 話し合う 話合う
はなしあおう	話しあおう 話し合おう
はなしあっ	話しあっ 話し合っ 話合っ
はなしあわ	話しあわ 話し合わ 話合わ
はなしかけ	話かけ 話しかけ 話し掛け
はなしかけよう	話しかけよう 話し掛けよう
はなしかける	話かける 話しかける 話し掛ける
はなしかけれ	話しかけれ 話し掛けれ
はなしこみ	話しこみ 話し込み
はなしこむ	話しこむ 話し込む
はなしこん	話しこん 話し込ん
はなす	放す 話す 離す
はなせ	放せ 話せ 離せ
はなせる	放せる 話せる 離せる
はなせれ	話せれ 離せれ
はなそう	放そう 話そう 離そう
はなやい	花やい 華やい
はなれ	放れ 離れ
はなれる	放れる 離れる
はね	刎ね 撥ね 跳ね
はねあがっ	はね上がっ ハネ上がっ 跳ねあがっ 跳ね上がっ 跳ね上っ
はねあがり	はね上がり 跳ね上がり
はねあがる	はね上がる ハネ上がる 跳ねあがる 跳ね上がる 跳ね上る
はねあげ	はね上げ 撥ね上げ 跳ね上げ
はねあげる	はね上げる 跳ね上げる
はねおき	はね起き 跳ね起き
はねかえさ	はね返さ 撥ね返さ 跳ね返さ
はねかえし	はね返し ハネ返し 撥ね返し 跳ね返し
はねかえす	はね返す ハネ返す 撥ね返す 跳ね返す
はねかえそう	はね返そう 跳ね返そう
はねかえっ	はね返っ 撥ね返っ 跳ねかえっ 跳ね返っ
はねかえり	はね返り 撥ね返り 跳ね返り
はねかえる	はね返る 撥ね返る 跳ね返る
はねころし	撥ね殺し 跳ね殺し
はねつけ	撥ねつけ 撥ね付け
はねつける	撥ねつける 撥ね付ける
はねとばさ	はね飛ばさ 刎ね飛ばさ 撥ね飛ばさ 跳ね飛ばさ
はねとばし	はね飛ばし 刎ね飛ばし 跳ね飛ばし
はねとばす	はね飛ばす 刎ね飛ばす 撥ね飛ばす 跳ね飛ばす
はねとび	跳ねとび 跳ね飛び
はねとん	はね飛ん 跳ね飛ん
はねのけ	はね退け はね除け ハネのけ 撥ねのけ 撥ね退け 撥ね除け 跳ねのけ 跳ね除け
はねのける	はね退ける はね除ける 撥ね退ける 跳ね除ける
はねまわっ	跳ねまわっ 跳ね回っ
はねまわり	跳ねまわり 跳ね回り
はねまわる	跳ねまわる 跳ね回る
はねよう	刎ねよう 撥ねよう 跳ねよう
はねる	ハネる 刎ねる 撥ねる 跳ねる
はねれ	ハネれ 刎ねれ
はばかっ	憚かっ 憚っ
はばから	憚から 憚ら
はばかる	憚かる 憚る
はばたい	羽ばたい 羽搏い
はばたき	羽ばたき 羽搏き 羽撃き 翔き
はばたく	羽ばたく 羽搏く 羽撃く 翔く
はばたけ	羽ばたけ 翔け
はま	喰ま 食ま
はまっ	ハマっ 填っ 填まっ 嵌っ 嵌まっ
はまら	ハマら 填まら 嵌まら 嵌ら
はまり	ハマり 填まり 填り 嵌まり 嵌り
はまりこみ	はまり込み 嵌まり込み
はまりこむ	はまり込む 嵌まり込む 嵌りこむ
はまりこん	はまり込ん 嵌まり込ん 嵌りこん
はまる	ハマる 填まる 填る 嵌まる 嵌る
はまれ	ハマれ 填れ 嵌れ
はまろう	ハマろう 嵌ろう
はみ	喰み 食み
はみださ	はみ出さ ハミ出さ
はみだし	はみ出し ハミ出し 食み出し
はみだす	はみ出す ハミ出す
はみだせ	はみ出せ ハミ出せ
はむ	喰む 食む
はむかい	刃向い 刃向かい 歯向かい
はむかう	刃向う 刃向かう 歯向かう
はむかえ	刃向かえ 歯向かえ
はむかおう	刃向おう 刃向かおう 歯向かおう
はむかっ	刃向かっ 刃向っ 歯向かっ 歯向っ
はむかわ	刃向かわ 刃向わ 歯向かわ
はめ	塡 塡め 填め 嵌め 食め
はめあわせ	はめ合わせ 嵌め合わせ
はめあわせる	はめ合わせる 嵌め合わせる
はめこま	はめ込ま 填め込ま 嵌め込ま
はめこみ	はめ込み 填め込み 嵌め込み
はめこむ	はめ込む 填め込む 嵌め込む
はめこもう	はめ込もう 塡め込もう 嵌め込もう
はめこん	はめ込ん 塡め込ん 填め込ん 嵌め込ん
はめよう	ハメよう 嵌めよう
はめる	ハメる 填める 嵌める
はやさ	囃さ 生やさ
はやし	囃し 生やし
はやしたて	はやし立て 囃したて 囃し立 囃し立て
はやしたてる	はやし立てる 囃したてる 囃し立てる
はやす	囃す 生やす
はやっ	はやッ 早っ 流行っ 逸っ
はやまっ	早まっ 速まっ 逸まっ
はやまり	早まり 速まり
はやまる	早まる 速まる
はやめ	早め 速め
はやめよう	早めよう 速めよう
はやめる	早める 速める
はやら	ハヤら 流行ら 速ら 逸ら
はやり	流行り 逸り
はやる	ハヤる 早る 流行る 逸る
はやれ	流行れ 逸れ
はら	張ら 貼ら
はらい	払い 祓い
はらいおとし	はらい落とし 払い落し 払い落とし
はらいおとす	払い落す 払い落とす
はらいおとそう	払い落そう 払い落とそう
はらいきよめ	払い清め 祓い浄め 祓い清め
はらいきよめる	祓い浄める 祓い清める
はらいこむ	払い込む 払込む
はらいこん	払い込ん 払込ん
はらいのけ	払いのけ 払い退け 払い除け
はらいのけよう	払いのけよう 払い除けよう
はらいのける	払いのける 払い除ける
はらいもどさ	払い戻さ 払戻さ
はらいもどし	払いもどし 払い戻し 払戻し
はらいもどす	払いもどす 払い戻す 払戻す
はらう	払う 攘う 祓う
はらえ	払 払え 祓え
はらえる	払える 祓える
はらおう	払おう 祓おう
はらさ	張らさ 晴らさ 腫らさ 貼らさ
はらし	晴らし 腫らし
はらす	張らす 晴らす 腫らす
はらっ	払っ 祓っ
はらは	払は 拂は
はらばい	腹ばい 腹這い
はらばっ	腹ばっ 腹這っ
はらへ	払へ 祓へ
はらむ	妊む 孕む
はらわ	払わ 祓わ
はらん	妊ん 孕ん
はり	墾り 張り 貼り
はりあい	張りあい 張り合い
はりあう	張りあう 張り合う
はりあげ	はり上げ 張りあげ 張り上げ 張上げ
はりあげる	はり上げる 張り上げる
はりあわさ	張り合わさ 貼り合わさ
はりあわせ	張り合わせ 貼りあわせ 貼り合せ 貼り合わせ
はりあわせる	はり合わせる 張り合わせる 貼りあわせる 貼り合せる 貼り合わせる
はりあわせれ	張り合わせれ 貼りあわせれ 貼り合わせれ
はりかえ	張りかえ 張り替え 貼りかえ 貼り変え 貼り換え 貼り替え
はりかえる	張り替える 貼りかえる 貼り換える 貼り替える
はりかさね	張り重ね 貼り重ね
はりかさねる	張り重ねる 貼り重ねる
はりきっ	張りきっ 張り切っ 張切っ
はりきり	張りきり 張り切り 張切り
はりこみ	張り込み 張込み
はりこむ	張りこむ 張り込む
はりこめる	張り込める 貼り込める
はりたおさ	はり倒さ 張り倒さ
はりたおし	はり倒し 張り倒し
はりたおす	はり倒す 張り倒す
はりださ	はり出さ 張りださ 張り出さ 張出さ 貼り出さ
はりだし	張りだし 張り出し 張出し 貼り出し
はりだす	張りだす 張り出す 張出す 貼り出す
はりだそう	張り出そう 貼り出そう
はりつい	張りつい 張り付い 張付い 貼りつい 貼り付い 貼り継い
はりつか	張り付か 貼りつか 貼り付か
はりつき	張りつき 張り付き 貼りつき 貼り付き
はりつく	張りつく 張り付く 貼りつく 貼り付く
はりつけ	はり付け 張りつけ 張り付け 張付け 磔 貼りつけ 貼り付け 貼付
はりつけよう	張り付けよう 貼りつけよう 貼り付けよう
はりつける	はり付ける 張りつける 張り付ける 磔る 貼りつける 貼り付ける 貼付る
はりつけれ	張り付けれ 貼りつけれ 貼り付けれ
はりつめ	張りつめ 張り詰め 張詰め
はりめぐらさ	張りめぐらさ 張り巡らさ 張巡らさ 貼りめぐらさ
はりめぐらし	張りめぐらし 張り巡らし 張り廻らし 貼りめぐらし
はりめぐらす	張りめぐらす 張り巡らす
はりめぐらせ	張りめぐらせ 張り巡らせ 張り廻らせ 貼りめぐらせ
はりめぐらせる	張りめぐらせる 張り巡らせる
はりわたさ	張りわたさ 張り渡さ
はりわたし	張りわたし 張り渡し
はる	墾る 張る 貼る
はれ	張れ 晴れ 腫 腫れ 貼れ 霽れ
はれあがっ	はれ上がっ 晴れ上がっ 腫れあがっ 腫れ上がっ
はれあがら	腫れあがら 腫れ上がら
はれあがり	はれ上がり 晴れ上がり 腫れあがり 腫れ上がり
はれあがる	はれ上がる 晴れ上がる 腫れあがる 腫れ上がる
はれる	張れる 晴れる 腫る 腫れる 貼れる
はろう	張ろう 払う 貼ろう
はわ	匍わ 這わ
はん	喰ん 食ん
ばかげ	バカげ 莫迦げ 馬鹿げ
ばくし	縛し 駁し
ばくする	縛する 駁する
ばけ	化 化け
ばっし	罰し 跋し
ばらひ	払ひ 拂ひ
ばらまい	ばら撒い ばら蒔い バラまい
ばらまか	ばら撒か バラまか
ばらまき	ばら撒き ばら蒔き バラまき
ばらまく	ばら撒く ばら蒔く バラまく
ばれ	暴露 破礼
ぱにくる	パニくる パニクる
ひ	乾 干 簸
ひあがっ	乾上がっ 乾上っ 干あがっ 干上がっ
ひあがら	乾上がら 干上がら
ひあがる	干あがる 干上がる
ひい	奏い 延い 引い 弾い 惹い 挽い 曳い 牽い
ひえこん	冷えこん 冷え込ん
ひか	引か 弾か 惹か 挽か 曳か 牽か 碾か 轢か 魅か
ひかえ	扣え 控え
ひかさ	引かさ 弾かさ 落籍さ
ひかし	惹かし 落籍し
ひから	光ら 炯ら 閃ら
ひからび	干からび 干涸び
ひかりかがやい	光り輝い 光輝い
ひかりかがやか	光り輝か 光輝か
ひかりかがやき	光り輝き 光輝き
ひかりかがやく	ひかり輝く 光りかがやく 光り輝く 光輝く
ひき	奏き 引き 弾き 惹き 挽き 曳き 曵き 牽き 碾き 轢き 魅き
ひきあい	引きあい 引き合い
ひきあう	引きあう 引き合う
ひきあがっ	引きあがっ 引き上がっ
ひきあげ	ひき上げ 引きあげ 引き上げ 引き揚げ 引上げ 引揚げ
ひきあげよ	引き上げよ 引き揚げよ
ひきあげよう	引きあげよう 引き上げよう 引き揚げよう 引上げよう
ひきあげる	ひき上げる 引きあげる 引き上げる 引き揚げる 引上げる 引揚げる
ひきあげれ	引きあげれ 引き上げれ 引き揚げれ
ひきあげろ	引き上げろ 引き揚げろ
ひきあっ	引きあっ 引き合っ
ひきあて	引きあて 引き当て 引当て
ひきあてる	引き当てる 引当てる
ひきあわさ	引きあわさ 引き合わさ
ひきあわせ	ひき会わせ ひき合わせ 引きあわせ 引き会わせ 引き合せ 引き合わせ
ひきあわせよう	引き会わせよう 引き合わせよう
ひきあわせる	引きあわせる 引き会わせる 引き合せる 引き合わせる
ひきい	率 率い
ひきいる	引き入る 率いる 率る
ひきいれ	ひき入れ 引きいれ 引き入れ 引入れ 惹き入れ 曳き入れ 率いれ 率れ
ひきいれよう	ひき入れよう 引き入れよう 引入れよう
ひきいれる	引きいれる 引き入れる 引入れる
ひきうけ	ひき受け 引きうけ 引き受け 引き請け 引受け
ひきうけよう	引き受けよう 引受けよう
ひきうける	ひき受ける 引きうける 引き受ける 引受ける
ひきうつし	引き写し 引き移し
ひきうつす	引き写す 引き移す
ひきおこさ	ひき起こさ ひき起さ 引きおこさ 引き起こさ 引き起さ 引起こさ 引起さ 惹き起こさ 惹き起さ
ひきおこし	ひき起こし ひき起し 引きおこし 引き起こし 引き起し 引起こし 引起し 惹きおこし 惹き起こし 惹き起し
ひきおこす	ひき起こす 引きおこす 引き起こす 引き起す 引起こす 引起す 惹き起こす 惹き起す
ひきおこせ	引き起こせ 引起せ
ひきおこそう	引きおこそう 引き起こそう 引き起そう
ひきおとさ	引き落さ 引き落とさ 引落さ
ひきおとし	引き落し 引き落とし 引落し 引落とし
ひきおとす	引き落とす 引落す
ひきおろさ	引きおろさ 引き下ろさ 引き降ろさ
ひきおろし	ひき降ろし 引きおろし 引き下ろし 引き降ろし
ひきおろす	引きおろす 引き下す 引き下ろす 引き降ろす
ひきおろそう	引き下ろそう 引き降ろそう
ひきかえ	引きかえ 引き換 引き換え 引き替え 引換 引換え 引替え
ひきかえさ	引きかえさ 引き帰さ 引き返さ
ひきかえし	ひき返し 引きかえし 引き帰し 引き返し 引返し 引還し
ひきかえす	引きかえす 引き帰す 引き返す 引返す
ひきかえせ	引き返せ 引返せ
ひきかえる	引き換える 引き替える 引換える 引換る 引替える
ひきくらべ	引きくらべ 引き比べ 弾き比べ
ひきこま	引きこま 引き込ま
ひきこみ	引きこみ 引き込み
ひきこむ	ひき込む 引きこむ 引き込む
ひきこもう	引きこもう 引き込もう
ひきこもっ	引きこもっ 引き篭っ 引き篭もっ 引き籠っ 引き籠もっ 引篭っ 引篭もっ 引籠もっ
ひきこもり	引きこもり 引き篭もり 引き篭り 引き籠もり 引き籠り 引き込もり 引篭もり 引篭り
ひきこもる	引きこもる 引き篭もる 引き籠もる 引き籠る
ひきころさ	ひき殺さ 轢き殺さ 轢殺さ
ひきころし	ひき殺し 轢き殺し 轢殺し
ひきころす	ひき殺す 轢き殺す
ひきころせ	ひき殺せ 轢き殺せ
ひきころそう	ひき殺そう 轢き殺そう
ひきこん	引きこん 引き込ん
ひきさい	引きさい 引き裂い 引裂い
ひきさか	ひき裂か 引きさか 引き裂か 引裂か
ひきさがっ	引きさがっ 引き下がっ 引き下っ 引き退っ
ひきさがら	引きさがら 引き下がら 引き退ら
ひきさがり	引きさがり 引き下がり
ひきさがる	引きさがる 引き下がる 引下る
ひきさき	引きさき 引き裂き 引裂き
ひきさく	ひき裂く 引きさく 引き裂く 引裂く
ひきさげ	ひき下げ 引きさげ 引き下げ 引下げ
ひきさげる	引きさげる 引き下げる 引下げる
ひきさげれ	引き下げれ 引下げれ
ひきしぼっ	引きしぼっ 引き絞っ
ひきしぼら	引きしぼら 引き絞ら
ひきしまっ	ひき締まっ 引きしまっ 引き締っ 引き締まっ
ひきしめ	引き締め 引締め
ひきしめる	引きしめる 引き締める
ひきすえ	引きすえ 引き据え
ひきずっ	引きずっ 引き摺っ 引摺っ
ひきずら	引きずら 引き摺ら 引摺ら
ひきずり	引きずり 引き摺り 引摺り
ひきずる	引きずる 引き摺る
ひきたた	引きたた 引き立た 引立た
ひきたっ	引きたっ 引き立っ
ひきたて	ひき立て 引きたて 引き立て 引立て
ひきたてる	ひき立てる 引きたてる 引き立てる
ひきださ	引きださ 引き出さ 引出さ
ひきだし	ひき出し 引きだし 引き出し 引出し 抽き出し
ひきだす	ひき出す 引きだす 引き出す 引出す
ひきだせ	ひき出せ 引き出せ
ひきだせる	引きだせる 引き出せる
ひきだそう	引きだそう 引き出そう
ひきちぎっ	引きちぎっ 引き千切っ
ひきちぎら	引きちぎら 引き千切ら
ひきちぎり	引きちぎり 引き千切り
ひきちぎる	引きちぎる 引き千切る
ひきちぎれ	引きちぎれ 引き千切れ
ひきつい	ひき継い 引きつい 引き継い 引継い
ひきつが	ひき継が 引きつが 引き継が 引継が
ひきつぎ	引きつぎ 引き継ぎ 引継ぎ
ひきつぐ	ひき継ぐ 引きつぐ 引き継ぐ 引継ぐ
ひきつけ	引きつけ 引き付け 引付け 惹きつけ 魅きつけ
ひきつけよう	引きつけよう 引き付けよう 惹きつけよう
ひきつける	引きつける 引き付ける 惹きつける 魅きつける
ひきつげる	引き継げる 引継げる
ひきつごう	引きつごう 引き継ごう
ひきつっ	引きつっ 引き攣っ
ひきつづい	ひき続い 引きつづい 引き続い 引続い
ひきつづき	ひき続き 引きつづき 引き続き 引続き
ひきつづく	引きつづく 引き続く 引続く
ひきつぶさ	引き潰さ 挽き潰さ 轢き潰さ
ひきつぶし	ひき潰し 引き潰し 挽き潰し 轢き潰し
ひきつぶす	ひき潰す 引き潰す
ひきつら	引きつら 引き攣ら
ひきつり	引きつり 引き吊り
ひきつる	引きつる 引き攣る
ひきつれ	ひき連れ 引きつれ 引き攣れ 引き連れ 引連れ
ひきとっ	引きとっ 引き取っ
ひきとめ	ひき止め 引きとめ 引き止め 引き留め 引止め 引留め
ひきとめよう	ひき止めよう 引きとめよう 引き止めよう 引き留めよう 引留めよう
ひきとめる	引きとめる 引き止める 引き留める 引止める 引留める
ひきとめろ	引きとめろ 引き留めろ
ひきとら	引きとら 引き取ら
ひきとり	引きとり 引き取り
ひきとる	ひき取る 引きとる 引き取る
ひきなおし	引き直し 引直し
ひきならし	引き鳴らし 弾き鳴らし
ひきならす	ひき鳴らす 引き鳴らす
ひきぬい	引きぬい 引き抜い 引抜い
ひきぬか	引きぬか 引き抜か 引抜か
ひきぬき	引きぬき 引き抜き 引抜き
ひきぬく	引きぬく 引き抜く 引抜く
ひきのばさ	引きのばさ 引き伸ばさ 引き延ばさ 引伸さ 引伸ばさ
ひきのばし	ひき伸ばし ひき延ばし 引きのばし 引き伸し 引き伸ばし 引き延ばし 引伸し 引伸ばし 引延ばし
ひきのばす	引きのばす 引き伸ばす 引き延ばす 引延ばす
ひきのばせ	引きのばせ 引き伸ばせ 引き延ばせ
ひきのばせる	引き伸ばせる 引き延ばせる
ひきのばそう	引き伸ばそう 引き延ばそう
ひきはがさ	引きはがさ 引き剥がさ
ひきはがし	引きはがし 引き剝がし 引き剥がし
ひきはがす	引きはがす 引き剥がす
ひきはがそう	引きはがそう 引き剥がそう
ひきはなさ	ひき離さ 引きはなさ 引き離さ
ひきはなし	引き放し 引き離し 引離し
ひきはなす	引きはなす 引き放す 引き離す 引離す
ひきはらい	引き払い 引払い
ひきはらう	引き払う 引払う
ひきはらっ	引きはらっ 引き払っ
ひきまわさ	引きまわさ 引き回さ 引き廻さ 引廻さ 曳き回さ 曳き廻さ
ひきまわし	引きまわし 引き回し 引き廻し 引回し 引廻し 曳き回し 曳き廻し
ひきまわす	引きまわす 引き回す 引き廻す 引回す 曳き回す 曳き廻す
ひきもどさ	引きもどさ 引き戻さ
ひきもどし	引きもどし 引き戻し 引戻し
ひきよせ	ひき寄せ 引きよせ 引き寄せ 引寄せ 惹き寄せ
ひきよせよう	引き寄せよう 引寄せよう
ひきよせる	引きよせる 引き寄せる 引寄せる 惹き寄せる
ひきわけ	引き分け 引分け
ひきわける	引き分ける 引分ける
ひきわたさ	引きわたさ 引き渡さ 引渡さ
ひきわたし	引きわたし 引き渡し 引渡し
ひきわたす	引きわたす 引き渡す 引渡す
ひきわたせ	引き渡せ 引渡せ
ひきわり	ひき割り 引き割り
ひく	奏く 引く 弾く 惹く 挽く 曳く 牽く 輓く
ひけ	引け 弾け 惹け 挽け 曳け 牽け
ひける	引ける 弾ける 惹ける 曳ける 牽ける
ひけれ	引けれ 弾けれ
ひこ	引こ 弾こ
ひこう	引こう 弾こう 惹こう 曳こう
ひざまずい	膝まずい 跪い
ひざまずか	膝まずか 跪か
ひざまずき	膝まずき 跪き
ひざまずく	膝まずく 跪く
ひし	比し 秘し
ひしめい	犇い 犇めい
ひしめきあう	ひしめき合う 犇めき合う
ひしめきあっ	ひしめき合っ 犇めき合っ
ひしめく	犇く 犇めく
ひする	比する 秘する
ひすれ	比すれ 秘すれ
ひせ	比せ 秘せ
ひたはしっ	ひた走っ 直走っ
ひたはしる	ひた走る 直走る
ひっかい	引っかい 引っ掻い 引っ搔い
ひっかか	引っかか 引っ掻か
ひっかかっ	引っかかっ 引っ掛かっ 引っ掛っ
ひっかから	引っかから 引っ掛から
ひっかかり	引っかかり 引っ掛かり 引っ掛り
ひっかかる	引っかかる 引っ掛かる 引っ掛る
ひっかかれ	引っかかれ 引っ掛かれ
ひっかき	引っかき 引っ掻き 引っ搔き
ひっかく	引っかく 引っ掻く 引っ搔く
ひっかけ	引っかけ 引っ掛け 引っ掻け
ひっかける	引っかける 引っ掛ける
ひっくりかえさ	ひっくり返さ 引っくり返さ 引っ繰り返さ
ひっくりかえし	ひっくり返し 引っくり返し 引っ繰り返し
ひっくりかえす	ひっくり返す 引っくり返す 引っ繰り返す
ひっくりかえせ	ひっくり返せ 引っくり返せ
ひっくりかえそう	ひっくり返そう 引っくり返そう
ひっくりかえっ	ひっくり返っ 引っくり返っ 引っ繰り返っ 引繰り返っ
ひっくりかえり	ひっくり返り 引っくり返り 引っ繰り返り
ひっくりかえる	ひっくり返る 引繰り返る
ひっこさ	引っ越さ 引越さ
ひっこし	引っこし 引っ越し 引越し
ひっこす	引っ越す 引越す
ひっこせ	引っ越せ 引越せ
ひっこそう	引っ越そう 引越そう
ひっこぬき	ひっこ抜き 引っこ抜き
ひっこぬく	ひっこ抜く 引っこ抜く
ひっこま	引っこま 引っ込ま
ひっこみ	引っこみ 引っ込み
ひっこむ	引っこむ 引っ込む
ひっこめ	引っこめ 引っ込め 引込 引込め
ひっこめる	引っこめる 引っ込める
ひっこん	引っこん 引っ込ん
ひっさげ	引っさげ 引っ下げ 引っ提げ 引提げ
ひっし	必し 筆し
ひったくり	引ったくり 引っ手繰り
ひっつい	ひっ付い 引っ付い
ひっつかむ	引っつかむ 引っ掴む
ひっつかん	引っつかん 引っ掴ん
ひっとらえ	ひっ捕らえ 引っ捕え
ひっぱたい	引っぱたい 引っ叩い
ひっぱたか	引っぱたか 引っ叩か
ひっぱたき	引っぱたき 引っ叩き
ひっぱたく	引っぱたく 引っ叩く
ひっぱっ	引っぱっ 引っ張っ 引張っ
ひっぱら	引っぱら 引っ張ら 引張ら
ひっぱり	引っぱり 引っ張り 引張り
ひっぱる	引っぱる 引っ張る 引張る
ひっぱれ	引っぱれ 引っ張れ
ひっぱれる	引っぱれる 引っ張れる
ひとりごち	独りごち 独り言ち
ひなび	鄙 鄙び
ひねくれ	ヒネくれ 捻くれ
ひねっ	ヒネっ 捻っ
ひねら	ヒネら 捻ら
ひねり	拈り 捻り
ひねりあげる	捻りあげる 捻り上げる
ひねりださ	ひねり出さ 捻り出さ
ひねりだし	ひねり出し 捻り出し
ひねりだす	ひねり出す 捻り出す
ひねれ	捻れ 撚れ
ひびきあい	響きあい 響き合い
ひびきあう	ひびき合う 響きあう 響き合う
ひびきあっ	響きあっ 響き合っ
ひびわれ	ひび割れ ヒビ割れ
ひもとい	紐解い 繙い
ひもとき	紐解き 繙き
ひもとく	紐解く 繙く
ひもとけ	紐解け 繙け
ひやさ	冷さ 冷やさ
ひやし	冷し 冷やし
ひやす	冷す 冷やす
ひょうし	表し 評し
ひょうする	表する 評する
ひょうせ	表せ 評せ
ひらい	ヒラい 啓い 墾い 展い 披い 拓い 開い
ひらか	ヒラか 啓か 披か 拓か 開か 開らか
ひらき	ヒラき 披き 拓き 開き 開らき
ひらきなおっ	開きなおっ 開き直っ
ひらきなおり	開きなおり 開き直り
ひらく	ヒラく 啓く 展く 披く 拓く 開く
ひらけ	ヒラけ 啓け 展け 拓け 開 開け
ひらける	拓ける 開ける 開らける
ひらこ	啓こ 開こ
ひらこう	ヒラこう 啓こう 拓こう 開こう
ひらめい	閃い 閃めい
ひるがえる	翻る 飜る
ひれふさ	ひれ伏さ 平伏さ
ひれふし	ひれ伏し 平伏し
ひれふす	ひれ伏す 平伏す
ひろいあげ	拾いあげ 拾い上げ
ひろいあげる	拾いあげる 拾い上げる
ひろいあげれ	拾いあげれ 拾い上げれ
ひろがっ	広がっ 拡がっ 拡っ
ひろがら	広がら 拡がら
ひろがり	広がり 拡がり
ひろがる	広がる 拡がる
ひろがれ	広がれ 拡がれ
ひろがろう	広がろう 拡がろう
ひろげ	広げ 拡げ 開げ
ひろげよう	広げよう 拡げよう
ひろげる	展げる 広げる 拡げる
ひろげれ	広げれ 拡げれ 開げれ
ひろげろ	広げろ 拡げろ 開げろ
ひろげん	広げん 拡げん
ひろまっ	広まっ 拡まっ
ひろまり	広まり 弘まり 拡まり
ひろまる	広まる 弘まる 拡まる
ひろまれ	広まれ 弘まれ
ひろめ	広め 弘め 拡め 擴め
ひろめる	広める 弘める 拡める
ひんし	瀕し 貧し
ひんする	瀕する 貧する
ひんむい	ひん剥い 引ん剥い
びい	碾い 轢い
びく	碾く 轢く
ふい	吹い 噴い 拭い 葺い
ふうじこま	封じこま 封じ込ま
ふうじこみ	封じこみ 封じ込み
ふうじこむ	封じこむ 封じ込む
ふうじこめ	封じこめ 封じ込め
ふうじこめよう	封じこめよう 封じ込めよう
ふうじこめる	封じこめる 封じ込める
ふえ	増 増え 殖え
ふえよ	増えよ 殖えよ
ふえる	増える 増る 殖える
ふか	吹か 噴か 拭か 葺か
ふかし	吹かし 噴かし 深し 蒸かし
ふかす	吹かす 噴かす 蒸かす
ふかせ	吹かせ 噴かせ 更せ 深せ
ふかめあう	深めあう 深め合う
ふかめあおう	深めあおう 深め合おう
ふかめあっ	深めあっ 深め合っ
ふき	吹き 噴き 拭き 葺き
ふきあがっ	吹きあがっ 吹き上がっ 噴きあがっ 噴き上がっ
ふきあがり	吹きあがり 吹き上がり 噴きあがり 噴き上がり
ふきあがる	吹きあがる 吹き上がる 吹き上る 噴きあがる 噴き上がる
ふきあげ	ふき上げ 吹きあげ 吹き上げ 吹上げ 噴きあげ 噴き上げ 拭き上げ
ふきあげる	吹き上げる 噴き上げる 拭き上げる
ふきあれ	吹きあれ 吹き荒れ
ふきおこる	吹きおこる 吹き起こる
ふきおとさ	吹き落さ 吹き落とさ
ふきおり	吹き下り 吹き降り
ふきおりる	吹き下りる 吹き降りる
ふきおろさ	吹き下ろさ 葺き下ろさ
ふきおろし	吹きおろし 吹き下ろし 吹き降ろし 葺きおろし 葺き下ろし
ふきおろす	吹きおろす 吹き下ろす 吹き降ろす 葺き下ろす
ふきかえ	ふき替え 吹きかえ 吹き替え 葺きかえ 葺き替え
ふきかえし	ふき返し 吹き返し 吹返し
ふきかえる	ふき替える 吹き替える 葺き替える
ふきかけ	吹きかけ 吹き掛け
ふきかける	吹きかける 吹き掛ける
ふきけさ	吹き消さ 拭き消さ
ふきこぼれ	吹きこぼれ 吹き零れ
ふきこぼれる	吹きこぼれる 吹き零れる
ふきこま	吹きこま 吹き込ま
ふきこみ	吹きこみ 吹き込み
ふきこむ	ふき込む 吹きこむ 吹き込む
ふきこめ	吹きこめ 吹き込め
ふきこもう	吹きこもう 吹き込もう
ふきこん	ふき込ん 吹きこん 吹き込ん
ふきさらさ	吹きさらさ 吹き晒さ
ふきすさん	吹きすさん 吹き荒ん
ふきたて	吹きたて 吹き立て
ふきたてる	吹きたてる 吹き立てる
ふきださ	吹き出さ 噴き出さ 噴出さ
ふきだし	ふき出し 吹きだし 吹き出し 吹出し 噴きだし 噴き出し 噴出し
ふきだす	ふき出す 吹きだす 吹き出す 吹出す 噴きだす 噴き出す 噴出す
ふきだまり	吹きだまり 吹き溜まり
ふきつけ	吹きつけ 吹き付け 吹付け
ふきつける	吹きつける 吹き付ける 吹付ける
ふきで	吹きで 吹き出 噴き出
ふきでる	ふき出る 吹き出る 噴きでる 噴き出る
ふきとっ	ふき取っ 拭きとっ 拭き取っ
ふきとばさ	ふき飛ばさ 吹きとばさ 吹き飛ばさ 噴き飛ばさ
ふきとばし	ふき飛ばし 吹きとばし 吹き飛ばし 噴き飛ばし
ふきとばす	吹きとばす 吹き飛ばす
ふきとばそう	吹きとばそう 吹き飛ばそう
ふきとら	ふき取ら 拭きとら 拭き取ら
ふきとり	ふき取り 拭きとり 拭き取り 拭取り
ふきとる	ふき取る 拭きとる 拭き取る
ふきぬけ	吹きぬけ 吹き抜け 吹抜け
ふきぬける	吹きぬける 吹き抜ける
ふきはらわ	吹きはらわ 吹き払わ 拭き払わ
ふきよせ	吹きよせ 吹き寄せ
ふきわけ	吹き分け 吹分け
ふく	吹く 噴く 拭く 葺く
ふくさ	復さ 服さ
ふくし	伏し 復し 服し
ふくす	復す 服す
ふくする	伏する 復する 服する
ふくせ	伏せ 復せ 服せ
ふくま	含ま 銜ま
ふくみ	含み 銜み
ふくむ	含 含む 銜む
ふくらま	脹らま 膨らま
ふくらみ	脹らみ 膨み 膨らみ
ふくらむ	脹らむ 膨む 膨らむ
ふくらん	脹らん 膨らん 膨ん
ふくれ	脹れ 膨れ
ふくれあがっ	ふくれ上がっ 脹れあがっ 脹れ上がっ 膨れあがっ 膨れ上がっ 膨れ上っ
ふくれあがら	膨れあがら 膨れ上がら
ふくれあがり	ふくれ上がり 脹れ上がり 膨れあがり 膨れ上がり
ふくれあがる	ふくれ上がる 脹れ上がる 膨れあがる 膨れ上がる 膨れ上る
ふくれる	脹れる 膨れる
ふけ	吹け 噴け 拭け 更け 深け 老け 葺け 蒸け
ふけこみ	老けこみ 老け込み
ふけこん	老けこん 老け込ん
ふけゆく	更けゆく 更け行く
ふけよ	吹けよ 拭けよ
ふける	フケる 吹ける 拭ける 更ける 深ける 老ける 耽ける 耽る
ふこう	吹こう 拭こう
ふさ	付さ 伏さ 臥さ 賦さ 附さ
ふさがら	塞がら 塞ら
ふさがり	塞がり 塞り
ふさがる	塞がる 塞る
ふさぎこみ	ふさぎ込み 塞ぎ込み
ふさぎこむ	ふさぎ込む 塞ぎ込む 鬱ぎ込む
ふさぎこん	ふさぎ込ん 塞ぎ込ん 鬱ぎ込ん
ふさげ	塞げ 遮げ
ふし	付し 伏し 臥し 賦し 附し
ふしおがみ	伏しおがみ 伏し拝み
ふす	付す 伏す 臥す 賦す 附す
ふする	付する 賦する 附する
ふせ	付せ 伏せ 臥 臥せ 附せ
ふせい	拒い 防い
ふせが	禦が 防が
ふせぎ	拒ぎ 防ぎ
ふせっ	伏せっ 臥せっ
ふせら	伏せら 臥せら 臥ら
ふせり	伏せり 臥せり 臥り
ふせる	伏せる 臥せる 臥る
ふそう	付そう 伏そう 附そう
ふちどっ	縁どっ 縁取っ
ふちどら	縁どら 縁取ら
ふちどり	縁どり 縁取り
ふちどる	縁どる 縁取る
ふっ	振っ 降っ
ふっかけ	吹っかけ 吹っ掛け
ふっかける	吹っかける 吹っ掛ける
ふっきっ	ふっ切っ 吹っ切っ
ふっきる	ふっ切る 吹っ切る
ふっきれ	ふっ切れ 吹っきれ 吹っ切れ
ふっとば	吹っとば 吹っ飛ば
ふっとばさ	ふっ飛ばさ 吹っ飛ばさ
ふっとばし	ふっ飛ばし 吹っ飛ばし
ふっとばす	ふっ飛ばす 吹っ飛ばす
ふっとばせ	ふっ飛ばせ 吹っ飛ばせ
ふっとび	ふっ飛び 吹っ飛び
ふっとぶ	ふっ飛ぶ 吹っ飛ぶ
ふっとん	ふっ飛ん 吹っ飛ん
ふてくされ	ふて腐れ 不貞腐れ
ふてくされる	ふて腐れる 不貞腐れる
ふとっ	太っ 太ッ 肥っ
ふとら	太ら 肥ら
ふとり	太り 肥り
ふとる	太る 肥る
ふま	践ま 踏ま
ふまえ	踏まえ 踏まへ
ふみ	履み 践み 踏み
ふみあらし	踏み荒し 踏み荒らし
ふみいる	踏みいる 踏み入る
ふみいれ	ふみ入れ 踏みいれ 踏み入れ
ふみおろし	踏みおろし 踏み下ろし 踏み降ろし
ふみおろす	踏みおろす 踏み下ろす 踏み降ろす
ふみかえ	踏みかえ 踏み変え 踏み替え
ふみかえる	踏みかえる 踏み変える 踏み替える
ふみきっ	踏みきっ 踏み切っ 踏切っ
ふみきり	踏みきり 踏み切り 踏切り
ふみきる	踏みきる 踏み切る 踏切る
ふみこえ	踏みこえ 踏み超え 踏み越え
ふみこえる	踏みこえる 踏み超える 踏み越える
ふみこたえ	踏みこたえ 踏み堪え
ふみこま	踏みこま 踏み込ま
ふみこみ	踏みこみ 踏み込み 踏込み
ふみこむ	踏みこむ 踏み込む
ふみこめ	踏みこめ 踏み込 踏み込め 踏込
ふみこん	ふみ込ん 踏みこん 踏み込ん 踏込ん
ふみしめ	踏みしめ 踏み締め
ふみしめる	踏みしめる 踏み締める
ふみたおし	踏み倒し 踏倒し
ふみたおす	踏み倒す 踏倒す
ふみだし	ふみ出し 踏みだし 踏み出し 踏出し
ふみだす	踏みだす 踏み出す
ふみだそう	踏みだそう 踏み出そう
ふみつけ	踏みつけ 踏み付け 踏付け
ふみつける	踏みつける 踏み付ける
ふみつぶさ	踏みつぶさ 踏み潰さ
ふみつぶし	踏みつぶし 踏み潰し
ふみつぶす	踏みつぶす 踏み潰す
ふみつぶそう	踏みつぶそう 踏み潰そう
ふみとどまっ	踏みとどまっ 踏み止まっ 踏み留まっ
ふみとどまら	踏みとどまら 踏み止まら 踏み留まら
ふみとどまり	踏みとどまり 踏み止まり 踏み留まり 踏止り
ふみとどまる	踏みとどまる 踏み止まる 踏み留まる
ふみとどまれ	踏みとどまれ 踏み止まれ 踏み留まれ
ふみとどまれる	踏みとどまれる 踏み留まれる
ふみとどまろう	踏みとどまろう 踏み止まろう
ふみならさ	踏みならさ 踏み均さ 踏み鳴らさ
ふみならし	踏みならし 踏み均し 踏み鳴らし
ふみならす	踏みならす 踏み鳴らす
ふみにじっ	踏みにじっ 踏み躙っ
ふみにじら	踏みにじら 踏み躙ら 踏躙ら
ふみにじり	踏みにじり 踏み躙り
ふみにじる	踏みにじる 踏み躙る
ふみはずさ	踏みはずさ 踏み外さ
ふみはずし	踏みはずし 踏み外し
ふみはずす	踏みはずす 踏み外す
ふみやぶっ	踏みやぶっ 踏み破っ
ふむ	履む 践む 踏む
ふめ	践め 踏め
ふもう	履もう 踏もう
ふやさ	増やさ 殖やさ
ふやし	増やし 殖やし
ふやす	増やす 殖やす
ふやせ	増せ 増やせ
ふやせよ	増やせよ 殖やせよ
ふやせる	増せる 増やせる 殖やせる
ふやそう	増やそう 殖やそう
ふら	振ら 降ら
ふらさ	振らさ 降らさ
ふらし	振らし 降らし
ふらす	振らす 降らす
ふり	振り 降り
ふりあう	振りあう 振り合う
ふりあげ	ふり上げ 振りあげ 振り上 振り上げ
ふりあっ	振りあっ 振り合っ
ふりあて	振りあて 振り当て
ふりいれ	ふり入れ 振り入れ
ふりおち	振り落ち 降り落ち
ふりおとさ	ふり落とさ 振り落さ 振り落とさ
ふりおとし	振り落し 振り落とし
ふりおとす	振り落す 振り落とす
ふりおろさ	振りおろさ 振り下ろさ 振り降ろさ
ふりおろし	振りおろし 振り下し 振り下ろし 振り降ろし 降り下ろし
ふりおろす	振り下す 振り下ろす 振り降ろす
ふりおろせ	振りおろせ 振り下せ 振り下ろせ
ふりおろそう	振り下ろそう 振り降ろそう
ふりかえ	振りかえ 振り替え 振替 振替え
ふりかえっ	ふり返っ 振りかえっ 振り返えっ 振り返っ 振返っ
ふりかえら	ふり返ら 振り返えら 振り返ら
ふりかえり	ふり返り 振りかえり 振り返えり 振り返り 振返り
ふりかえる	ふり返る 振りかえる 振り替える 振り替る 振り返える 振り返る 振替える 振返る
ふりかえれ	ふり返れ 振りかえれ 振り替えれ 振り返れ
ふりかえろう	振り返ろう 振返ろう
ふりかかっ	降りかかっ 降り掛かっ
ふりかかり	降りかかり 降り懸かり 降り掛かり
ふりかかる	降りかかる 降り懸かる 降り掛かる
ふりかけ	振りかけ 振り掛け 降り掛け
ふりかける	振りかける 振り掛ける
ふりかざす	振りかざす 振り翳す
ふりかぶら	振りかぶら 振り被ら
ふりかぶり	振りかぶり 振り被り
ふりきっ	振りきっ 振り切っ 振切っ
ふりきら	振りきら 振り切ら
ふりきり	振りきり 振り切り
ふりきる	ふり切る 振りきる 振り切る
ふりきれ	振りきれ 振り切れ
ふりこま	振り込ま 振込ま 降り込ま
ふりこみ	振りこみ 振り込み 振込み 降り込み
ふりこむ	振り込む 振込む 降り込む
ふりこめ	振りこめ 振り込め 降り込め
ふりこん	振りこん 振り込ん 振込ん 降り込ん
ふりしきる	降りしきる 降り頻る
ふりしぼっ	振りしぼっ 振り絞っ
ふりしぼり	ふり絞り 振り絞り
ふりすて	ふり捨て 振り捨て 振り棄て
ふりそそい	降りそそい 降り注い
ふりそそが	降りそそが 降り注が
ふりそそぎ	ふり注ぎ 降りそそぎ 降り注ぎ
ふりそそぐ	降りそそぐ 降り注ぐ
ふりたて	ふり立て 振りたて 振り立て
ふりださ	振り出さ 振出さ
ふりだし	振り出し 振出し
ふりだす	振り出す 振出す
ふりつもっ	降り積っ 降り積もっ
ふりつもる	降りつもる 降り積もる 降り積る
ふりはなし	振り放し 振り離し
ふりはらい	振りはらい 振り払い
ふりはらえ	振りはらえ 振り払え
ふりほどい	振りほどい 振り解い
ふりほどか	振りほどか 振り解か
ふりほどき	振りほどき 振り解き
ふりまい	ふり撒い 振りまい 振り撒い
ふりまか	ふり撒か 振りまか 振り撒か
ふりまき	振りまき 振り撒き
ふりまく	振りまく 振り撒く
ふりまける	振りまける 振り撒ける
ふりまぜる	振りまぜる 振り混ぜる
ふりまわさ	ふり回さ 振りまはさ 振りまわさ 振り回さ
ふりまわし	ふり回し ふり廻し 振りまはし 振りまわし 振り回し 振り廻し
ふりまわす	ふり回す 振りまわす 振り回す 振回す
ふりみだし	ふり乱し 振りみだし 振り乱し
ふりむい	ふり向い 振りむい 振り向い 振向い
ふりむか	ふり向か 振りむか 振り向か 振向か
ふりむき	ふり向き 振りむき 振り向き
ふりむく	ふり向く 振り向く 振向く
ふりむけ	ふり向け 振り向け
ふりむける	ふり向ける 振り向ける 振向ける
ふりやま	降りやま 降り止ま
ふりやん	降りやん 降り止ん
ふりわけ	ふり分け 振り分け 振分け
ふりわける	振りわける 振り分ける
ふる	振る 降る
ふるい	奮い 振い 振るい 揮い 篩い 震い
ふるいおこし	ふるい起こし 奮い起こし 奮い起し
ふるいおこす	奮い起こす 振い起す
ふるいおとさ	ふるい落さ ふるい落とさ 振るい落とさ 篩い落とさ
ふるいおとし	ふるい落し ふるい落とし 振い落とし 振るい落とし 篩い落とし
ふるいおとす	ふるい落とす 振るい落とす 篩い落とす
ふるいたた	奮いたた 奮い立た
ふるいたち	ふるい立ち 奮い立ち
ふるいたっ	ふるい立っ 奮いたっ 奮い立っ
ふるいたつ	ふるい立つ 奮い立つ
ふるいわけ	ふるい分け 篩い分け
ふるいわける	ふるい分ける 篩い分ける
ふるう	奮う 振う 振るう 揮う 篩う 震う
ふるえ	奮え 慄え 振え 振るえ 篩え 震え
ふるえあがっ	震えあがっ 震え上がっ
ふるえあがら	ふるえ上がら 震えあがら 震え上がら
ふるえあがり	震えあがり 震え上がり 震え上り
ふるえあがる	ふるえ上がる 震えあがる 震え上がる
ふるえる	慄える 振える 振るえる 揮える 震える 顫える
ふるおう	奮おう 振るおう
ふるっ	奮っ 振るっ 揮っ 篩っ 震っ
ふるは	振は 揮は
ふるひ	振ひ 揮ひ
ふるび	古び 旧び
ふるふ	振ふ 震ふ
ふるまい	振るまい 振る舞い 振舞い
ふるまう	振るまう 振る舞う 振舞う
ふるまえ	振るまえ 振る舞え 振舞え
ふるまえる	振る舞える 振舞える
ふるまおう	振る舞おう 振舞おう
ふるまっ	振るまっ 振る舞っ 振舞っ
ふるまわ	振るまわ 振る舞わ 振舞わ
ふるわ	奮わ 振るわ 振わ 揮わ 篩わ 震わ
ふれ	振れ 狂れ 触れ 觸 降れ
ふれあい	ふれ合い 触れあい 触れ合い
ふれあう	ふれ合う 触れあう 触れ合う
ふれあえる	触れあえる 触れ合える
ふれあっ	ふれ合っ 触れあっ 触れ合っ
ふれあるく	ふれ歩く 触れ歩く
ふれまわっ	ふれ回っ 触れまわっ 触れ回っ
ふれまわら	ふれ回ら 触れ回ら
ふれまわり	ふれ回り 触れまわり 触れ回り
ふれまわる	触れまわる 触れ回る
ふれよ	振れよ 触れよ
ふれる	振れる 触れる
ふれれ	振れれ 触れれ
ふろう	振ろう 降ろう
ふん	履ん 践ん 踏ん
ふんづける	踏んづける 踏ん付ける
ふんばっ	踏んばっ 踏ん張っ
ふんばら	踏んばら 踏ん張ら
ふんばる	踏んばる 踏ん張る 踏張る
ぶちあげ	ぶち上げ ブチあげ ブチ上げ
ぶちあげる	ぶち上げる ブチあげる
ぶちあたっ	ぶち当たっ ぶち当っ 打ち当たっ
ぶちあたる	ぶち当たる 打ち当たる
ぶちきれ	ぶち切れ ブチ切れ
ぶちきれる	ぶち切れる ブチ切れる
ぶちこま	ぶち込ま ブチ込ま
ぶちこみ	ぶち込み ブチ込み
ぶちこむ	ぶち込む ブチ込む
ぶちころす	ぶち殺す ブチ殺す
ぶちころせ	ぶち殺せ ブチ殺せ
ぶちこわさ	ぶち壊さ 打ち壊さ
ぶちこわし	ぶち壊し 打ち壊し 打ち毀し
ぶちこわす	ぶち壊す 打ち壊す 打ち毀す
ぶちこわせ	ぶち壊せ 打ち壊せ
ぶちこわそう	ぶち壊そう 打ち壊そう 打ち毀そう
ぶちこん	ぶち込ん ブチ込ん
ぶちぬい	ぶち抜い 打ち抜い
ぶちぬか	ぶち抜か 打ち抜か
ぶちぬき	ぶち抜き ブチ抜き 打ち抜き
ぶちぬく	ぶち抜く 打ち抜く
ぶちぬけ	ぶち抜け 打ち抜け
ぶちまけ	ぶち撒け ブチまけ
ぶちまける	ぶち撒ける ブチまける 打ち撒ける
ぶっころし	ぶっ殺し ブッ殺し
ぶっころす	ぶっ殺す ブッ殺す
ぶっこわし	ぶっ壊し 打壊し
ぶっこわれる	ぶっ壊れる ブッ壊れる
ぶったぎっ	ぶった切っ ぶった斬っ
ぶったぎる	ぶった切る ぶった斬る
ぶっとば	ぶっ飛ば ブッとば
ぶっとばし	ぶっ飛ばし ブッ飛ばし
ぶっとばす	ぶっ飛ばす ブッ飛ばす
ぶっとばせ	ぶっ飛ばせ ブッ飛ばせ
ぶっとび	ぶっ飛び ブッとび
ぶっとぶ	ぶっ飛ぶ ブッとぶ
ぶっとん	ぶっ飛ん ブッとん
ぶっぱなす	ぶっ放す ブッ放す
ぶらさがっ	ぶら下がっ ぶら下っ
ぶらさがり	ぶら下がり ぶら下り ブラ下がり
ぶらさがる	ぶら下がる ぶら下る
ぶりかえし	ぶり返し 振り返し
ぶりかえす	ぶり返す 振り返す
ぶんどっ	ぶん取っ 分捕っ
ぶんどり	ぶん取り 分捕り
ぶんなぐっ	ぶん殴っ ブン殴っ
へ	歴 経 經
へこむ	ヘコむ 凹む
へしおっ	へし折っ ヘシ折っ
へしおら	へし折ら ヘシ折ら
へしおる	へし折る 圧し折る
へだたっ	隔たっ 隔っ
へだたる	隔たる 隔る
へだて	距て 隔て
へだてる	距てる 隔てる
へめぐっ	経めぐっ 経巡っ
へめぐり	経めぐり 経巡り
へら	減ら 空ら
へりくだっ	へり下っ 謙っ 遜っ
へりくだり	へり下り 謙り 遜り
へりくだる	謙る 遜る
へる	歴る 減る 経る
へれ	減れ 経れ
へんし	偏し 編し 貶し
へんじ	変じ 變じ
へんする	偏する 編する 貶する
へんせ	偏せ 編せ
べたつく	べた付く ベタつく
ほうじ	報じ 奉じ 崩じ 焙じ
ほうじよう	報じよう 奉じよう
ほうじる	報じる 奉じる 崩じる 焙じる
ほうずる	報ずる 奉ずる 崩ずる 焙ずる
ほうぜ	報ぜ 奉ぜ
ほうっ	抛っ 放っ
ほうむら	葬むら 葬ら
ほうむりさっ	葬りさっ 葬り去っ
ほうむりさら	葬りさら 葬り去ら
ほうむりさる	葬りさる 葬り去る
ほうむりさろう	葬りさろう 葬り去ろう
ほうむる	葬むる 葬る
ほうりあげ	ほうり上げ 放り上げ
ほうりあげる	ほうり上げる 放り上げる
ほうりこま	放りこま 放り込ま
ほうりこみ	ほうり込み 放り込み
ほうりこむ	ほうり込む 放りこむ 放り込む
ほうりこめ	ほうり込め 放り込め
ほうりこん	ほうり込ん 放りこん 放り込ん
ほうりすてる	ほうり捨てる 放り捨てる 放り棄てる
ほうりださ	ほうり出さ 抛り出さ 放りださ 放り出さ
ほうりだし	抛り出し 放りだし 放り出し
ほうりだす	放りだす 放り出す
ほうりだそう	ほうり出そう 放り出そう
ほうりなげ	ほうり投げ 放りなげ 放り投げ
ほうりなげる	放りなげる 放り投げる
ほえ	吠え 吼え 咆え
ほえたて	吠えたて 吠え立て
ほえたてる	吠えたてる 吠え立てる
ほえる	吠える 吼える 咆える
ほえろ	吠えろ 吼えろ 咆えろ
ほおばっ	ほお張っ 頬張っ
ほおばり	ほお張り 頬張り
ほおばる	ほお張る 頬張る
ほかけ	帆かけ 帆掛け
ほこり	矜り 誇り
ほこる	矜る 誇る
ほし	ホし 乾し 保し 干し 補し
ほじくりかえさ	ほじくり返さ 穿り返さ
ほじくりだし	ほじくり出し 穿り出し
ほす	ホす 乾す 干す
ほする	保する 補する
ほせ	ホせ 干せ 補せ
ほっ	彫っ 掘っ
ほっぽりだし	ほっぽり出し 放っぽり出し
ほとばしりでる	ほとばしり出る 迸り出る
ほねばっ	骨ばっ 骨張っ
ほのめかさ	仄かさ 仄めかさ
ほのめかし	仄かし 仄めかし
ほほえみ	ほほゑみ ほほ笑み 微笑み
ほほえむ	ほほゑむ ほほ笑む 微笑む
ほほえん	ほほ笑ん 微笑ん
ほめ	褒め 誉め 讃め 賞め
ほめあい	ほめ合い 褒めあい 褒め合い
ほめあげ	ほめ上げ 褒め上げ 誉め上げ
ほめごろし	ホメ殺し 褒め殺し
ほめそやさ	褒めそやさ 誉めそやさ
ほめそやし	褒めそやし 誉めそやし
ほめそやす	褒めそやす 誉めそやす
ほめたたえ	ほめ讃え ほめ賛え 褒めたたえ 褒め称え 褒め讃え 誉めたたえ 誉め称え 誉め讃え
ほめたたえる	ほめ称える ほめ讃える 褒めたたえる 褒め称える 褒め讃える 誉め称える 誉め讃える
ほめたたえん	ほめ讃えん 褒め称えん
ほめる	褒める 誉める
ほめれ	褒めれ 誉めれ
ほめろ	褒めろ 誉めろ
ほら	彫ら 掘ら
ほり	彫り 掘り
ほりあげ	彫りあげ 彫り上げ 掘り上げ
ほりあげる	彫りあげる 彫り上げる 掘り上げる
ほりあて	掘りあて 掘り当て
ほりあてよう	掘りあてよう 掘り当てよう
ほりあてる	掘りあてる 掘り当てる
ほりおこさ	掘りおこさ 掘り起こさ
ほりおこし	彫り起こし 掘りおこし 掘り起こし 掘り起し
ほりおこす	掘りおこす 掘り起こす 掘り起す
ほりおこそう	掘り起こそう 掘り起そう
ほりかえし	掘りかえし 掘り返し
ほりくぼめ	掘りくぼめ 掘り窪め
ほりこま	彫りこま 彫り込ま 掘りこま 掘り込ま
ほりこみ	彫りこみ 彫り込み 掘りこみ 掘り込み
ほりこむ	彫りこむ 彫り込む 掘り込む
ほりこん	彫りこん 彫り込ん 掘りこん 掘り込ん
ほりさげ	彫り下げ 掘りさげ 掘り下げ 掘下げ
ほりさげる	掘りさげる 掘り下げる
ほりすすみ	彫り進み 掘り進み
ほりすすむ	掘りすすむ 掘り進む
ほりすすめ	彫り進め 掘りすすめ 掘り進め
ほりすすめる	彫り進める 掘り進める
ほりださ	彫り出さ 彫出さ 掘りださ 掘り出さ 掘出さ
ほりだし	彫り出し 彫出し 掘りだし 掘り出し 掘出し
ほりだす	彫り出す 掘りだす 掘り出す 掘出す
ほりだそう	掘りだそう 掘り出そう
ほりとっ	掘りとっ 掘り取っ
ほりとる	掘りとる 掘り取る
ほりぬい	掘り抜い 掘抜い
ほりぬき	掘り抜き 掘抜き
ほりのこし	彫り残し 掘り残し
ほりわけ	彫り分け 掘り分け
ほる	彫る 掘る
ほれ	彫れ 惚れ 掘れ
ほれこま	ほれ込ま 惚れ込ま
ほれこみ	ほれ込み 惚れこみ 惚れ込み
ほれこむ	ほれ込む 惚れこむ 惚れ込む
ほれこん	ほれ込ん 惚れこん 惚れ込ん
ほれる	彫れる 惚れる 掘れる
ほろう	彫ろう 掘ろう
ほろび	亡び 滅び
ほろびさっ	滅びさっ 滅び去っ
ほろびさる	亡び去る 滅び去る
ほろびゆく	亡びゆく 亡び行く 滅びゆく 滅び行く
ほろびよう	亡びよう 滅びよう
ほろびる	亡びる 滅びる
ほろびん	亡びん 滅びん
ほろぶ	亡ぶ 滅ぶ
ほろぼさ	亡さ 亡ぼさ 滅さ 滅ぼさ
ほろぼし	亡ぼし 滅し 滅ぼし
ほろぼす	亡ぼす 滅す 滅ぼす
ほろぼせ	滅せ 滅ぼせ
ほろぼせる	滅せる 滅ぼせる
ほろぼそう	亡ぼそう 滅そう 滅ぼそう
ほろん	亡ん 滅ん
ぼかし	ボカし 暈し
ぼくし	卜し 牧し
ぼくする	卜する 牧する
ぼくせ	卜せ 牧せ
ぼけ	呆け 惚け 暈け
ぼける	ボケる 呆ける 暈ける
ぼっし	歿し 沒し 没し
ぼっす	歿す 没す
ぼっする	沒する 没する
まい	巻い 捲い 撒い 播い 舞い 蒔い
まいあがっ	舞いあがっ 舞い上がっ 舞い上っ
まいあがら	舞いあがら 舞い上がら
まいあがり	舞いあがり 舞い上がり
まいあがる	舞いあがる 舞い上がる
まいあがれ	舞いあがれ 舞い上がれ
まいおさめる	舞いおさめる 舞い納める
まいおどる	舞いおどる 舞い踊る
まいおり	舞いおり 舞い下り 舞い降り
まいおりる	舞い下りる 舞い降りる
まいこみ	まい込み 舞い込み 舞込み
まいこむ	舞いこむ 舞い込む
まいこん	まい込ん 舞いこん 舞い込ん 舞込ん
まいたっ	舞いたっ 舞い立っ
まいっ	参っ 詣っ
まいもどっ	舞い戻っ 舞戻っ
まいもどり	舞いもどり 舞い戻り 舞戻り
まいら	マイら 参ら 詣ら
まいり	参り 詣り
まいる	マイる 参る 詣る
まいれ	参れ 詣れ
まか	巻か 捲か 撒か 播か 纒か 蒔か
まかさ	任さ 委さ 巻かさ 負かさ
まかし	任し 委し 負かし
まかす	任す 委す 巻かす 負かす
まかせ	任せ 委せ 負かせ
まかせる	任せる 委せる 負かせる
まかそう	任そう 負かそう
まかりこし	まかり越し 罷り越し
まかりで	まかり出 罷り出
まかりとおっ	まかり通っ 罷り通っ
まかりとおり	まかり通り 罷り通り
まかりとおる	まかり通る 罷り通る
まがっ	曲がっ 曲っ
まがら	曲がら 曲ら
まがり	曲がり 曲り
まがりくねっ	曲がりくねっ 曲りくねっ
まがりくねる	曲がりくねる 曲りくねる
まがる	マガる 曲がる 曲る
まがれ	マガれ 曲がれ
まき	卷き 巻き 捲き 撒き 播き 蒔き
まきあがっ	巻きあがっ 巻き上がっ
まきあがる	巻きあがる 巻き上がる
まきあげ	巻きあげ 巻き上げ 巻き揚げ 巻上げ 捲きあげ 捲き上げ 捲揚げ
まきあげる	巻きあげる 巻き上げる 巻き揚げる 捲揚げる
まきおこさ	巻き起こさ 捲き起こさ
まきおこし	まき起こし まき起し 巻きおこし 巻き起こし 巻き起し 捲き起こし 捲き起し
まきおこす	まき起こす 巻き起こす 巻き起す 捲き起こす
まきおこっ	巻き起こっ 巻き起っ 巻起こっ 捲き起こっ
まきおこり	巻き起こり 巻き起り 捲き起こり
まきおこる	巻きおこる 巻き起こる 巻き起る 捲き起こる
まきおさめ	巻き収め 巻き納め
まきかえ	巻き換え 巻き替え
まきかえる	巻き変える 巻き替える
まきこま	まき込ま 巻きこま 巻き込ま 巻込ま 捲きこま 捲き込ま
まきこみ	巻きこみ 巻き込み 巻込み 捲き込み
まきこむ	巻きこむ 巻き込む 巻込む
まきこもう	巻きこもう 巻き込もう
まきこん	まき込ん 巻きこん 巻き込ん 巻込ん 捲きこん 捲き込ん
まきちらさ	まき散らさ 巻き散らさ 撒きちらさ 撒き散らさ
まきちらし	まき散らし 巻き散らし 撒き散らし 播き散らし
まきちらす	まき散らす 巻き散らす 捲き散らす 撒き散らす
まきちらそう	まき散らそう 撒き散らそう
まきつい	巻きつい 巻き付い
まきつか	巻きつか 巻き付か
まきつき	巻きつき 巻き付き 巻付き
まきつく	巻きつく 巻き付く
まきつけ	巻きつけ 巻き付け 巻付け 蒔き付け
まきつける	巻きつける 巻き付ける 巻付ける 蒔き付ける
まきつけれ	巻きつけれ 巻き付けれ
まきとっ	巻きとっ 巻き取っ 巻取っ
まきとり	巻き取り 巻取り
まきとる	巻きとる 巻き取る 巻取る
まきなおし	巻き直し 撒き直し
まきもどし	巻きもどし 巻き戻し
まきもどす	巻きもどす 巻き戻す
まぎれこま	紛れこま 紛れ込ま
まぎれこみ	まぎれ込み 紛れこみ 紛れ込み
まぎれこむ	まぎれ込む 紛れこむ 紛れ込む
まぎれこもう	紛れこもう 紛れ込もう
まぎれこん	まぎれ込ん 紛れこん 紛れ込ん
まく	巻く 捲く 撒く 播く 蒔く
まくしたて	まくし立て 捲し立て
まくしたてる	まくし立てる 捲し立てる
まくっ	マクっ 捲くっ 捲っ
まくら	マクら 捲くら 捲ら
まくり	捲くり 捲り
まくりあげ	まくり上げ 捲り上げ
まくりあげる	まくり上げる 捲り上げる
まくれあがっ	まくれ上がっ 捲れ上がっ
まくれあがり	まくれ上がり 捲れ上がり
まくろう	捲くろう 捲ろう
まけ	巻け 撒け 播け 敗け 蒔け 負け 負ケ
まける	巻ける 撒ける 敗ける 負ける
まけれ	撒けれ 敗けれ 負けれ
まけろ	撒けろ 負けろ
まげ	曲 曲げ 枉げ
まげる	曲げる 枉げる
まこう	巻こう 撒こう 播こう 蒔こう
まさっ	優っ 勝ッ 増さっ
まさり	優り 勝り 増さり
まさる	優る 勝る 増さる
まされ	優れ 勝れ
まさろう	優ろう 勝ろう
まざっ	交ざっ 混ざっ 雑ざっ
まざり	交ざり 混ざり 雑り
まざりあい	混ざりあい 混ざり合い
まざりあう	混ざりあう 混ざり合う
まざりあおう	混ざりあおう 混ざり合おう
まざりあっ	混ざりあっ 混ざり合っ
まざる	交ざる 混ざる
まし	増し 摩し
まじえ	交え 交じえ 混え 混じえ
まじえる	交える 交じえる 混じえる
まじっ	交じっ 交っ 混じっ 混っ
まじめくさっ	真面目くさっ 真面目腐っ
まじら	交ら 混じら
まじり	交じり 交り 混じり 混り 雑じり
まじりあい	交じり合い 混じりあい 混じり合い
まじりあう	交じり合う 混じりあう 混じり合う
まじりあっ	交じり合っ 混じりあっ 混じり合っ
まじりあわ	交じり合わ 混じり合わ
まじる	交じる 交る 混じる 雑じる
まじれ	混じれ 混れ
まじわっ	交っ 交わっ
まじわり	交り 交わり
まじわる	交る 交わる
まじわれ	交れ 交われ
ませ	増せ 摩せ
まぜ	交ぜ 混ぜ 雑ぜ
まぜあわせ	まぜ合わせ 交ぜ合わせ 混ぜあわせ 混ぜ合せ 混ぜ合わせ
まぜあわせよう	混ぜあわせよう 混ぜ合わせよう
まぜあわせる	まぜ合わせる 混ぜあわせる 混ぜ合せる 混ぜ合わせる
まぜかえし	まぜ返し 混ぜ返し
まぜかえす	まぜ返す 混ぜ返す
まぜる	交ぜる 混ぜる
また	俟た 待た
またがっ	股がっ 跨がっ 跨っ
またがら	跨がら 跨ら
またがり	股がり 跨がり 跨り
またがる	股がる 跨がる 跨る
またがれ	跨がれ 跨れ
またぎこし	またぎ越し 跨ぎ越し
またぎこす	またぎ越す 跨ぎ越す
まち	俟ち 待ち
まちあわせ	待ちあわせ 待ち合せ 待ち合わせ 待合せ 待合わせ
まちあわせる	待ち合せる 待ち合わせる
まちうけ	待ちうけ 待ち受け 待受け
まちうける	待ちうける 待ち受ける
まちかまえ	待ちかまえ 待ち構え 待構え
まちかまえる	待ちかまえる 待ち構える
まちがえる	間違える 間違へる
まちこがれ	待ちこがれ 待ち焦がれ
まちこがれる	待ちこがれる 待ち焦がれる
まちのぞむ	待ちのぞむ 待ち望む 待望む
まちのぞん	待ちのぞん 待ち望ん
まちぶせ	待ちぶせ 待ち伏せ 待伏せ
まちわび	待ちわび 待ち侘び
まっ	まッ 俟っ 待っ 舞っ
まつ	俟つ 待つ
まつっ	祀っ 祠っ 祭っ
まつら	奉ら 祀ら 祠ら 祭ら
まつり	奉り 祀り 祠り 祭り
まつりあげ	祭り上 祭り上げ
まつる	奉る 祀る 祠る 祭る 纏る
まつれ	祀れ 祠れ 祭れ
まつわりつい	纏わりつい 纏わり付い
まつわりつき	纏わりつき 纏わり付き
まつわりつく	纏わりつく 纏わり付く
まて	俟て 待 待て
まてる	待てる 待る
まとい	絡い 纏い 纒い
まとう	俟とう 待とう 絡う 纏う
まとっ	絡っ 纏っ 纒っ
まとめ	纏め 纒め
まとめあげ	まとめ上げ 纏め上げ
まとめあげる	まとめ上げる 纏め上げる
まとめなおさ	まとめ直さ 纏め直さ
まとめなおし	まとめ直し 纏め直し
まとめなおそう	まとめ直そう 纏め直そう
まとわ	絡わ 纏わ
まなび	学び 學び
まなびあい	学びあい 学び合い
まなびあう	学びあう 学び合う
まなびとっ	学びとっ 学び取っ
まなびとり	学びとり 学び取り
まなびとる	学びとる 学び取る
まなびとれる	学びとれる 学び取れる
まなびとろう	学びとろう 学び取ろう
まなぶ	学ぶ 學ぶ
まなん	学ん 學ん
まにあう	間にあう 間に合う
まにあっ	間にあっ 間に合っ
まにあわ	間にあわ 間に合わ
まぬがれ	免がれ 免れ
まぬがれる	免がれる 免れる
まねきいれ	招きいれ 招き入れ
まねきいれよう	招きいれよう 招き入れよう
まねきいれる	招きいれる 招き入れる
まねきよせ	まねき寄せ 招きよせ 招き寄せ
まねきよせる	まねき寄せる 招きよせる 招き寄せる
まもっ	守っ 衛っ 護っ
まもら	守ら 衛ら 護ら
まもり	守り 衛り 護り
まもりそだて	まもり育て 守り育て
まもる	守る 衛る 護る
まもれ	守れ 護れ
まもれる	守れる 護れる
まもろう	守ろう 護ろう
まよいこま	迷いこま 迷い込ま
まよいこみ	迷いこみ 迷い込み
まよいこむ	迷いこむ 迷い込む
まよいこん	まよい込ん 迷いこん 迷い込ん
まよいでる	まよい出る 迷い出る
まるめこま	丸めこま 丸め込ま
まるめこみ	丸めこみ 丸め込み
まるめこん	丸めこん 丸め込ん
まわさ	回さ 回わさ 廻さ 舞わさ
まわし	回し 回わし 廻し 旋し 舞わし
まわす	回す 回わす 廻す 廻わす 旋す 舞わす
まわせ	回せ 回わせ 廻せ 舞わせ
まわせる	回せる 廻せる
まわそう	回そう 廻そう
まわっ	周っ 回っ 回わっ 廻っ 輪っ
まわら	周ら 回ら 回わら 廻ら
まわり	周り 回り 回わり 廻り 輪り
まわりあるい	回り歩い 廻り歩い
まわりこま	まわり込ま 回りこま 回り込ま
まわりこみ	まわり込み 回りこみ 回り込み
まわりこむ	まわり込む 回りこむ 回り込む
まわりこめ	回りこめ 回り込め 回込め
まわりこもう	回りこもう 回り込もう
まわりこん	まわり込ん 回りこん 回り込ん
まわる	周る 回る 回わる 廻る 輪る
まわれ	周れ 回れ 廻れ
まわれよ	回れよ 廻れよ
まわれる	周れる 回れる 廻れる
まわろう	回ろう 廻ろう
み	看 瞥 見 視 覧 観 診 試
みあい	見あい 見合い
みあう	見あう 見合う
みあげ	見あげ 見上げ
みあげる	見あげる 見上げる
みあげれ	見あげれ 見上げれ
みあたら	見あたら 見当たら
みあっ	見あっ 見合っ
みあやまり	見あやまり 見誤り
みあわさ	見合さ 見合わさ
みあわす	見合す 見合わす
みあわせ	み合わせ 見あわせ 見合せ 見合わせ
みあわせる	み合わせる 見合せる 見合わせる
みいださ	見いださ 見い出さ 見出さ 見出ださ
みいだし	見いだし 見い出し 見出し 見出だし
みいだす	見いだす 見い出す 見出す 見出だす
みいだせ	見いだせ 見い出せ 見出せ 見出だせ
みいだせる	見いだせる 見い出せる 見出せる 見出だせる
みいだそう	見いだそう 見い出そう 見出そう 見出だそう
みいっ	見入っ 観入っ 魅入っ
みいら	見入ら 魅いら 魅入ら
みいり	見入り 魅入り
みいる	見入る 魅入る
みいれ	見入れ 魅入れ
みうけ	見うけ 見受 見受け
みうける	見うける 見受ける
みうしない	見失い 見失ない
みうしなっ	見失っ 見失なっ
みえ	見え 視え 観え
みえすい	見えすい 見え透い
みえる	見える 視える 観える
みおとさ	見落さ 見落とさ
みおとし	見落し 見落とし
みおとす	見落す 見落とす
みおろさ	見おろさ 見下ろさ
みおろし	見おろし 見下ろし 見降ろし
みおろす	見おろす 見下ろす 見降ろす
みおろせ	見おろせ 見下ろせ 見降ろせ
みかえし	見かえし 見返し
みかえす	見かえす 見返す
みかえる	見かえる 見返る
みかけ	見かけ 見掛け
みかける	見かける 見掛ける
みかね	見かね 見兼ね
みがい	研い 磨い
みがか	研か 磨か
みがき	研き 磨き
みがきあげ	磨きあげ 磨き上げ
みがきあげる	磨きあげる 磨き上げる
みがく	研く 磨く
みがこう	研こう 磨こう
みきり	見きり 見切り
みきれ	見きれ 見切れ
みきわめ	見きわめ 見極め 見究め
みきわめよう	見きわめよう 見極めよう
みきわめる	見きわめる 見極める
みくだし	見くだし 見下し
みくだす	見くだす 見下す
みくだせ	見くだせ 見下せ
みくびっ	見くびっ 見縊っ
みくびら	見くびら 見縊ら
みくらべ	見くらべ 見比べ
みこし	見こし 見越し
みこま	見こま 見込ま
みこむ	見こむ 見込む
みこめ	見こめ 見込め
みこん	見こん 見込ん
みごもっ	妊っ 身ごもっ 身篭っ 身篭もっ 身籠っ 身籠もっ
みごもら	身ごもら 身篭ら 身籠ら
みごもり	身ごもり 身篭り 身籠もり 身籠り
みごもる	身ごもる 身篭る 身籠もる 身籠る
みさげ	見さげ 見下げ
みさだめ	見さだめ 見定 見定め
みし	見し 視し 観し 診し 魅し
みすえ	見すえ 見据え
みすごさ	見すごさ 見過ごさ 見過さ
みすごし	看過ごし 見すごし 見過ごし 見過し
みすごす	看過ごす 見過ごす 見過す
みすて	見すて 見捨て 見棄 見棄て
みすてよう	見捨てよう 見棄てよう
みすてる	見捨てる 見棄てる
みすまし	見すまし 見澄まし
みする	ミスる 魅する
みせ	見せ 視せ 観せ 診せ 魅せ
みせあい	見せあい 見せ合い
みせあう	見せあう 見せ合う
みせあっ	見せあっ 見せ合っ
みせかけ	見せかけ 見せ掛け
みせかける	見せかける 見せ掛ける
みせつけ	見せつけ 見せ付け
みせつけよう	見せつけよう 見せ付けよう
みせつける	見せつける 見せ付ける
みせよう	見せよう 魅せよう
みせる	見せる 視せる 観せる 診せる 魅せる
みせろ	見せろ 魅せろ
みそめ	見そめ 見初め 見染め
みそめる	見そめる 見初める
みた	充た 満た
みたさ	充さ 充たさ 満さ 満たさ
みたし	充し 充たし 満し 満たし
みたす	充す 充たす 満す 満たす
みたせ	充たせ 満たせ
みたそう	充たそう 満そう 満たそう
みたて	見たて 見立て
みたてよう	見たてよう 見立てよう
みたてる	見たてる 見立てる
みだれ	乱れ 濫れ 紊れ
みだれとん	乱れとん 乱れ飛ん
みち	充ち 満ち 滿ち
みちあふれ	充ちあふれ 充ち溢れ 満ちあふれ 満ち溢れ
みちあふれる	満ちあふれる 満ち溢れる
みちがえ	見ちがえ 見違え
みちたり	充ち足り 満ちたり 満ち足り
みちびきいれ	導きいれ 導き入れ
みちびきださ	導きださ 導き出さ
みちびきだし	導きだし 導き出し
みちびきだす	導きだす 導き出す
みちびきだそう	導きだそう 導き出そう
みちみち	充ち満ち 満ちみち 満ち満ち
みちる	充ちる 満ちる 盈ちる
みつ	充つ 満つ
みつかっ	見つかっ 見付かっ
みつから	見つから 見付から
みつかり	見つかり 見付かり
みつかる	見つかる 見付かる
みつかれ	見つかれ 見付かれ
みつくろい	見つくろい 見繕い
みつくろっ	見つくろっ 見繕っ
みつけ	見つけ 見付け
みつけよう	見つけよう 見付けよう
みつける	見つける 見付ける
みつけれ	見つけれ 見付けれ
みつけろ	見つけろ 見付けろ
みつめ	見つめ 見凝め 見詰め 視つめ
みつめよう	見つめよう 見詰めよう
みつめる	見つめる 見詰める 視つめる
みつもっ	見積っ 見積もっ
みつもら	見つもら 見積もら 見積ら
みつもり	見つもり 見積もり 見積り
みつもる	見積もる 見積る
みつもれる	見積もれる 見積れる
みて	充て 満て
みとおさ	見とおさ 見通さ
みとおし	見とおし 見透し 見通し
みとがめ	見とがめ 見咎め
みとがめる	見とがめる 見咎める
みとっ	看取っ 見とっ 見取っ
みとどけ	見とどけ 見届け
みとめ	見とめ 認 認め
みとめあい	認めあい 認め合い
みとめあう	認めあう 認め合う
みとめあっ	認めあっ 認め合っ
みとめる	見とめる 認める 認る
みとめれ	見とめれ 認めれ 認れ
みとら	看とら 看取ら 見取ら
みとり	看とり 看取り 見とり 見取り
みとる	看とる 看取る 見とる 見取る
みとれ	看取れ 見とれ 見取れ 見惚れ
みとれる	看取れる 見とれる 見取れる 見惚れる
みとろう	看取ろう 見取ろう
みなおさ	見なおさ 見直さ
みなおし	見なおし 見直し
みなおす	見なおす 見直す
みなさ	看做さ 見さ 見なさ 見做さ
みなし	看做し 見なし 見做し
みなす	看做す 見す 見なす 見做す
みなせ	看做せ 見なせ 見做せ
みなせよう	看做せよう 見なせよう
みなせる	看做せる 見なせる 見做せる
みならい	見ならい 見倣い 見習い
みならう	見ならう 見倣う 見習う
みならっ	見ならっ 見倣っ 見習っ
みぬい	見ぬい 見抜い
みぬか	見ぬか 見抜か
みぬき	見ぬき 見抜き
みぬく	見ぬく 見抜く
みのがさ	見のがさ 見逃がさ 見逃さ
みのがし	見のがし 見逃がし 見逃し
みのがす	見のがす 見逃がす 見逃す
みのがせ	見のがせ 見逃せ
みのっ	実っ 稔っ
みのら	実ら 稔ら
みのり	実り 稔り
みのる	実る 稔る
みはからい	見はからい 見計い 見計らい
みはからっ	見はからっ 見計っ 見計らっ
みはっ	瞠っ 見張っ
みはなさ	見放さ 見離さ
みはなし	見放し 見離し
みはなせ	見放せ 見離せ
みはら	見はら 見張ら
みはらし	見張らし 見晴らし
みはらす	見張らす 見晴らす
みはり	見はり 見張り
みはる	瞠る 見はる 見張る
みはるかす	見はるかす 見晴るかす 見霽かす
みはれ	瞠れ 見はれ 見張れ
みひらか	見ひらか 見開か
みまかっ	薨っ 身罷っ
みまがう	見まがう 見紛う
みまがっ	見まがっ 見紛っ
みまもっ	見まもっ 見守っ
みまもり	見まもり 見守り 見護り
みまわ	見まわ 見舞わ
みまわし	見まわし 見回し 見廻し
みまわす	見まわす 見回す 見廻す
みまわせ	見まわせ 見回せ
みまわっ	見回っ 見廻っ
みまわり	見まわり 見回り 見廻り
みまわる	見まわる 見回る 見廻る
みまわれ	見まわれ 見回れ
みみなれ	耳慣れ 耳馴れ
みもだえ	身もだえ 身悶え
みもだえる	身もだえる 身悶える
みゃくうっ	脈うっ 脈打っ
みゃくうつ	脈うつ 脈打つ
みやっ	見やっ 見遣っ
みやぶら	看破ら 見破ら
みやる	見やる 見遣る
みよ	看よ 見よ 視よ 観よ 診よ
みよう	見よう 視よう 観よう 診よう
みる	看る 見る 視る 観る 診る 試る
みれ	看れ 見れ 視れ 観れ 試れ
みれる	見れる 観れる
みろ	見ろ 観ろ 診ろ
みわけ	見わけ 見分け
みわける	見わける 見分ける
みわたし	見わたし 見渡し
みわたす	見わたす 見渡す
みわたせ	見わたせ 見渡せ
みわたせる	見わたせる 見渡せる
むい	剝い 剥い 向い
むか	剥か 向か
むかい	向い 向かい 対い
むかいあい	向かいあい 向かい合い
むかいあう	向いあう 向かいあう 向かい合う
むかいあっ	向いあっ 向かいあっ 向かい合っ
むかいあわ	向かいあわ 向かい合わ
むかう	向う 向かう 対う
むかえ	向え 向かえ 対え 迎え 邀え
むかえいれ	迎えいれ 迎え入れ 迎へ入れ
むかえいれよう	迎えいれよう 迎え入れよう
むかえいれる	迎えいれる 迎え入れる
むかえうた	迎え撃た 迎え討た
むかえうち	迎えうち 迎え打ち 迎え撃ち 迎え討ち
むかえうっ	迎えうっ 迎え撃っ 迎え討っ
むかえうつ	迎えうつ 迎え打つ 迎え撃つ 迎え討つ
むかえうて	迎え撃て 迎え討て
むかえうとう	迎え打とう 迎え撃とう 迎え討とう
むかえとら	迎えとら 迎え取ら
むかえとり	迎えとり 迎え取り
むかえとる	迎えとる 迎え取る
むかえとろう	迎えとろう 迎え取ろう
むかえる	向かえる 迎える
むかおう	向おう 向かおう
むかっ	向かっ 向っ 対っ
むかひ	向ひ 嚮ひ
むかわ	向かわ 向わ
むき	剥き 向き
むきあい	向きあい 向き合い
むきあう	向きあう 向き合う
むきあおう	向きあおう 向き合おう
むきあっ	向きあっ 向き合っ
むきあわ	向きあわ 向き合わ
むきかえ	向きかえ 向き変え 向き替え
むきかえる	向きかえる 向き変える
むきだし	むき出し 剥きだし 剥き出し
むきだす	むき出す 剥き出す
むきなおっ	向きなおっ 向き直っ
むく	剝く 剥く 向く
むくい	報い 酬 酬い
むくいよう	報いよう 酬いよう
むくいる	報いる 酬いる
むくう	報う 酬う
むくわ	報わ 酬わ
むけ	剝け 剥け 却け 向け
むけなおし	向けなおし 向け直し
むけなおす	向けなおす 向け直す
むける	剥ける 却ける 向ける
むけれ	剥けれ 向けれ
むさ	産さ 蒸さ
むさぼりくい	むさぼり食い 貪り食い
むさぼりくう	むさぼり喰う むさぼり食う 貪り食う
むさぼりくっ	むさぼり食っ 貪り食っ
むさぼりくわ	むさぼり食わ 貪り食わ
むさぼりよみ	むさぼり読み 貪り読み
むさぼりよん	むさぼり読ん 貪り読ん
むさぼる	貧る 貪る
むし	生し 産し 蒸し
むしあがっ	蒸しあがっ 蒸し上がっ
むしあがる	蒸しあがる 蒸し上がる
むしかえさ	蒸し返さ 蒸返さ
むしら	ムシら 毟ら
むしりとっ	むしり取っ 毟り取っ
むしりとら	むしり取ら 毟り取ら
むしりとり	むしり取り 毟り取り
むしりとる	むしり取る 毟り取る
むしる	ムシる 毟る
むす	産す 蒸す
むすび	掬び 結び
むすびあう	結びあう 結び合う
むすびあっ	結びあっ 結び合っ
むすびあわさ	結びあわさ 結び合わさ
むすびあわせ	結びあわせ 結び合わせ
むすびあわせる	結びあわせる 結び合わせる
むすびつい	結びつい 結び付い
むすびつか	結びつか 結び付か
むすびつき	結びつき 結び付き
むすびつく	結びつく 結び付く
むすびつけ	結びつけ 結び付け
むすびつけよう	結びつけよう 結び付けよう
むすびつける	結びつける 結び付ける
むすびつこう	結びつこう 結び付こう
むすぶ	掬ぶ 結ぶ
むせ	咽 噎 噎せ 蒸せ
むせかえり	むせ返り 噎せ返り
むせかえる	むせ返る 咽せ返る 噎せ返る
むせびない	むせび泣い 咽び泣い
むせびなき	むせび泣き 咽び泣き
むせびなく	むせび泣く 咽び泣く
むせぶ	咽ぶ 噎ぶ
むせる	咽せる 蒸せる
むちうた	むち打た 鞭打た
むちうち	むち打ち ムチ打ち 鞭打ち
むちうっ	むち打っ 鞭打っ
むちうつ	むち打つ 鞭打つ
むつみあう	睦みあう 睦み合う
むらだっ	群だっ 群立っ
むれ	群れ 蒸れ
むれなし	群れなし 群れ成し
むれる	群れる 蒸れる
めあわさ	妻さ 妻合わさ 娶さ
めあわす	妻す 娶す
めあわせ	妻せ 妻合わせ 娶せ 娶わせ
めあわせよう	妻合わせよう 娶せよう 娶わせよう
めあわせる	妻合わせる 娶せる 娶わせる
めいじ	命じ 銘じ
めいじよ	命じよ 銘じよ
めいじる	命じる 銘じる
めいずる	命ずる 銘ずる
めかしこん	めかし込ん 粧し込ん
めがけ	目がけ 目掛け
めくりあげる	めくり上げる 捲り上げる
めくるめく	目くるめく 目眩く
めくれあがっ	めくれ上がっ 捲れあがっ
めくれあがり	めくれ上がり 捲れあがり
めぐっ	囲っ 巡っ 循っ 環っ 繞っ
めぐま	恵ま 惠ま
めぐまれ	恵まれ 恵れ
めぐみ	恵み 芽ぐみ 萌み
めぐむ	恤む 恵む 芽ぐむ
めぐも	恤も 恵も 惠も 萌も
めぐら	囲ら 巡ら 廻ら 循ら 環ら 繞ら
めぐらさ	回らさ 巡らさ 廻らさ
めぐらし	回らし 巡らし 廻らし 繞らし
めぐらす	巡らす 廻らす 繞らす
めぐらせ	回らせ 巡らせ
めぐり	囲り 巡り 循り 環り
めぐりあい	めぐり会い めぐり合い めぐり逢い 巡りあい 巡り会い 巡り合い 巡り逢い
めぐりあう	めぐり会う めぐり合う めぐり逢う 巡りあう 巡り会う 巡り合う 巡り逢う
めぐりあえ	めぐり会え めぐり合え めぐり逢え 巡りあえ 巡り会え 巡り合 巡り合え 巡り逢え
めぐりあえる	めぐり会える めぐり合える めぐり逢える 巡りあえる 巡り会える 巡り合える 巡り逢える
めぐりあえれ	めぐり逢えれ 巡り合えれ
めぐりあっ	めぐり会っ めぐり合っ めぐり逢っ 巡りあっ 巡り会っ 巡り合っ 巡り逢っ
めぐりあるい	めぐり歩い 巡り歩い
めぐりあるき	めぐり歩き 巡り歩き
めぐりあるく	めぐり歩く 巡り歩く
めぐりあわ	めぐり合わ めぐり逢わ 巡り会わ 巡り合わ
めぐりめぐっ	巡りめぐっ 巡り巡っ
めぐる	囲る 巡る 循る 環る 繞る
めさる	召さる 召る
めざさ	目ざさ 目差さ 目指さ
めざし	目ざし 目差し 目指し
めざす	目ざす 目差す 目指す
めざそう	目ざそう 目指そう
めざめ	目ざめ 目覚め 目醒め 眼ざめ 眼覚め 眼醒め
めざめよ	目ざめよ 目覚めよ 眼ざめよ
めざめる	目ざめる 目覚める 目醒める 眼覚める
めしあがれ	召しあがれ 召し上がれ
めしあげ	召しあげ 召し上げ 召上げ
めしあげる	召し上げる 召上げる
めしい	盲 盲い
めしかえさ	召し帰さ 召し返さ
めしかかえ	召しかかえ 召し抱え 召抱え
めしかかえよう	召し抱えよう 召抱えよう
めしかかえる	召し抱える 召抱える
めしださ	召し出さ 召出さ
めしだし	召し出し 召出し
めしつれ	召しつれ 召し連れ
めしとっ	召し取っ 召し捕っ
めしとら	召し取ら 召し捕ら
めしとらえ	召し捕え 召し捕らえ
めしとらえよ	召し捕えよ 召し捕らえよ
めしとらえる	召し捕える 召し捕らえる
めしとり	召し取り 召し捕り
めしとる	召し取る 召し捕る
めしよせ	召し寄せ 召寄せ
めだた	目だた 目立た
めだち	目だち 目立ち 芽だち 芽立ち
めだっ	目だっ 目立っ 芽だっ
めだつ	目だつ 目立つ
めで	愛で 賞で
めでる	愛でる 賞でる
めばえ	芽ばえ 芽生え
めばえる	芽ばえる 芽生える
めぶい	芽ぶい 芽吹い
めぶき	芽ぶき 芽吹き
めもる	メモる 目盛る
めりこむ	めり込む 減り込む
めりこん	めり込ん 減り込ん
めんくらう	面喰らう 面食らう
めんくらっ	面喰らっ 面食らっ
もうけ	儲け 設け
もうけよ	儲けよ 設けよ
もうけよう	儲けよう 設けよう
もうける	儲ける 設ける
もうけれ	儲けれ 設けれ
もうさ	申さ 白さ
もうし	申し 白し 盲し
もうしあげ	申しあげ 申し上げ 申上げ
もうしあげよ	申しあげよ 申し上げよ
もうしあげる	申しあげる 申し上げる 申上げる
もうしあわせ	申しあわせ 申し合せ 申し合わせ 申合わせ
もうしいれ	申しいれ 申し入れ 申入れ
もうしいれる	申し入れる 申入れる
もうしうけ	申し受け 申受
もうしこま	申しこま 申し込ま
もうしこむ	申しこむ 申し込む
もうしこめ	申し込め 申込
もうしこめる	申し込める 申込める
もうしこん	申しこん 申し込ん
もうしそえ	申しそえ 申し添え
もうしたて	申したて 申し立て 申立て
もうしたてる	申したてる 申し立てる 申立てる
もうしつけ	申しつけ 申し付 申し付け 申付 申付け
もうしつける	申しつける 申し付ける
もうしつけれ	申しつけれ 申し付けれ
もうしつたえ	申し伝え 申伝え
もうしで	申し出 申出
もうしでる	申し出る 申出る
もうしのべ	申し述べ 申述べ
もうしわたさ	申しわたさ 申し渡さ 申渡さ
もうしわたし	申しわたし 申し渡し 申渡し
もうしわたす	申しわたす 申し渡す 申渡す
もうす	申す 白す
もうせ	申せ 白せ
もえ	炎え 燃え 燃へ 萌え 萠
もえあがっ	燃えあがっ 燃え上がっ 燃え上っ
もえあがら	燃えあがら 燃え上がら
もえあがり	燃えあがり 燃え上がり 燃え上り
もえあがる	燃えあがる 燃え上がる 燃え上る
もえあがれ	燃えあがれ 燃え上がれ 萌え上がれ
もえいづる	萌え出づる 萌え出る
もえいで	萌えいで 萌え出で
もえうつり	燃えうつり 燃え移り
もえうつる	燃えうつる 燃え移る
もえさかっ	燃えさかっ 燃え盛っ
もえさかり	燃えさかり 燃え盛り
もえさかる	燃えさかる 燃え盛る
もえたぎっ	燃えたぎっ 燃え滾っ
もえたぎる	燃えたぎる 燃え滾る
もえたた	燃えたた 燃え立た
もえたっ	燃えたっ 燃え立っ
もえたつ	燃えたつ 燃え立つ 萌え立つ
もえつき	燃えつき 燃え付き 燃え尽き
もえつきよう	燃えつきよう 燃え尽きよう
もえつきる	燃えつきる 燃え尽きる
もえひろがっ	燃えひろがっ 燃え広がっ 燃え拡がっ
もえひろがり	燃えひろがり 燃え広がり 燃え拡がり
もえひろがる	燃え広がる 燃え拡がる
もえよ	燃えよ 萌えよ
もえる	炎える 燃える 萌える
もえろ	炎えろ 燃えろ 萌えろ
もぎとっ	もぎ取っ もぎ採っ
もぎとら	もぎ取ら 捥ぎ取ら
もぎとり	もぎ取り 捥ぎ取り
もぎとる	もぎ取る 捥ぎ取る
もくし	沐し 目し 黙し
もくす	目す 黙す
もくする	沐する 目する 黙する
もくせ	目せ 黙せ
もぐりこま	もぐり込ま 潜りこま 潜り込ま
もぐりこみ	もぐり込み 潜りこみ 潜り込み
もぐりこむ	もぐり込む 潜りこむ 潜り込む
もぐりこめる	潜りこめる 潜り込める
もぐりこもう	潜りこもう 潜り込もう
もぐりこん	もぐり込ん 潜りこん 潜り込ん
もし	摸し 模し
もた	以た 持た 有た
もたさ	持さ 持たさ
もたし	持し 持たし
もたす	持す 持たす
もたれ	モタれ 凭れ
もたれかかっ	もたれ掛かっ 凭れかかっ 凭れ掛かっ
もたれかかり	もたれ掛かり 凭り
もたれかかる	もたれ掛かる 凭れかかる
もだえくるしみ	もだえ苦しみ 悶え苦しみ
もだえくるしむ	もだえ苦しむ 悶え苦しむ
もだえくるしん	もだえ苦しん 悶え苦しん
もだえしぬ	もだえ死ぬ 悶え死ぬ
もち	以ち 持ち 有ち
もちあがっ	もち上がっ もち上っ 持ちあがっ 持ち上がっ 持ち上っ 持上っ
もちあがら	持ちあがら 持ち上がら
もちあがり	もち上がり 持ちあがり 持ち上がり 持ち上り 持上り
もちあがる	もち上がる 持ちあがる 持ち上がる 持ち上る
もちあげ	もち上げ 持ちあげ 持ち上げ 持上げ
もちあげよう	持ちあげよう 持ち上げよう
もちあげる	持ちあげる 持ち上げる 持上げる
もちあるい	持ちあるい 持ち歩い
もちあるく	もち歩く 持ち歩く
もちあわせ	もち合わせ 持ちあわせ 持ち合せ 持ち合わせ 持合わせ
もちあわせる	持ちあわせる 持ち合せる 持ち合わせる
もちい	用 用い 須い
もちいる	用いる 用る
もちいれ	用いれ 用れ
もちいん	用いん 須いん
もちかえ	持ちかえ 持ち代え 持ち変え 持ち換え 持ち替え 持替え
もちかえっ	もち帰っ 持ちかえっ 持ち帰っ 持ち返っ 持帰っ
もちかえら	持ちかえら 持ち帰えら 持ち帰ら
もちかえり	もち帰り 持ちかえり 持ち帰えり 持ち帰り 持ち返り 持帰り
もちかえる	持ちかえる 持ち変える 持ち帰る 持ち換える 持ち替える 持ち返る
もちかえれ	持ち帰れ 持ち替えれ
もちかけ	持ちかけ 持ち掛け 持掛け
もちかけよう	持ちかけよう 持ち掛けよう
もちかける	持ちかける 持ち掛ける
もちくずし	持ちくずし 持ち崩し
もちこさ	持ちこさ 持ち越さ 持越さ
もちこし	持ちこし 持ち越し 持越し
もちこす	持ちこす 持ち越す
もちこたえ	持ちこたえ 持ち堪え
もちこたえる	持ちこたえる 持ち堪える
もちこま	もち込ま 持ちこま 持ち込ま 持込ま
もちこみ	持ちこみ 持ち込み 持込み
もちこむ	もち込む 持ちこむ 持ち込む 持込む
もちこめ	持ちこめ 持ち込め 持込
もちこめる	持ちこめる 持ち込める
もちこもう	もち込もう 持ちこもう 持ち込もう
もちこん	もち込ん 持ちこん 持ち込ん 持込ん
もちさら	持ち去ら 持去ら
もちさり	持ち去り 持去り
もちださ	もち出さ 持ちださ 持ち出さ
もちだし	もち出し 持ちだし 持ち出し 持出し
もちだす	持ちだす 持ち出す 持出す
もちだそう	持ちだそう 持ち出そう
もちなおさ	持ちなおさ 持ち直さ
もちなおし	持ちなおし 持ち直し
もちなおす	持ちなおす 持ち直す
もちはこび	持ち運び 持運び
もちはこべる	持ち運べる 持運べる
もちはこん	持ちはこん 持ち運ん
もちまわり	持ち回り 持ち廻り
もちよっ	持ち寄っ 持寄っ
もちよら	持ちよら 持ち寄ら 持寄ら
もちより	持ちより 持ち寄り
もちよる	持ちよる 持ち寄る
もっ	以っ 持っ 有っ 漏っ 盛っ
もつ	以つ 持つ 有つ
もつれあい	もつれ合い 縺れ合い
もつれあう	もつれ合う 縺れ合う
もつれあっ	もつれ合っ 縺れ合っ
もつれこま	もつれ込ま 縺れ込ま
もつれこみ	もつれ込み 縺れ込み
もつれこむ	もつれ込む 縺れ込む
もつれこん	もつれ込ん 縺れ込ん
もて	以て 持て 有て
もてあそば	弄ば 玩ば
もてあそび	もて遊び 弄び 玩び
もてあそぶ	もて遊ぶ 弄ぶ 玩ぶ
もてあそん	もて遊ん 弄ん 玩ん
もてあまさ	持てあまさ 持て余さ
もてあまし	もて余し 持てあまし 持て余し 持余し
もてあます	もて余す 持てあます 持て余す 持余す
もてはやさ	もて囃さ 持てはやさ 持て囃さ
もてはやし	持てはやし 持て囃し
もてる	モテる 持てる
もと	以と 持と 有と
もとづい	基い 基づい 基付い
もとづか	基か 基づか
もとづき	基き 基づき 基付き 本き
もとづく	基く 基づく 基付く 本く
もとづけ	基け 基づけ 基付け 本け
もとめ	求め 索め 購め 需め
もとめあい	求めあい 求め合い
もとめあう	求めあう 求め合う
もとめあっ	求めあっ 求め合っ
もとめる	求める 需める
ものなれ	物なれ 物慣れ 物馴れ
もみあい	もみ合い 揉みあい 揉み合い
もみあう	もみ合う 揉みあう 揉み合う
もみあっ	もみ合っ 揉みあっ 揉み合っ
もみけさ	もみ消さ 揉み消さ
もみけし	もみ消し モミ消し 揉み消し 揉消し
もみけす	もみ消す モミ消す 揉み消す
もみけせる	もみ消せる 揉み消せる
もみけそう	もみ消そう 揉み消そう
もみこむ	もみ込む 揉み込む
もみこん	もみ込ん 揉み込ん
もみだし	もみ出し 揉み出し
もみつぶし	もみ潰し 揉み潰し
もみほぐし	揉みほぐし 揉み解し
もみほぐす	揉みほぐす 揉み解す
もめる	モメる 揉める
もやう	催合う 舫う
もやさ	燃さ 燃やさ
もやし	燃し 燃やし
もやす	燃す 燃やす
もやせ	燃せ 燃やせ
もら	漏ら 盛ら
もらいうけ	もらい受け 貰いうけ 貰い受け
もらいうける	もらい受ける 貰い受ける
もらえ	貰 貰え 貰へ
もらさ	洩らさ 漏らさ
もらし	洩し 洩らし 漏し 漏らし
もらす	洩す 洩らす 漏らす
もらせ	洩らせ 漏せ 漏らせ
もらそう	洩らそう 漏らそう
もり	漏り 盛り
もりあがっ	もり上がっ 盛りあがっ 盛り上がっ 盛り上っ
もりあがら	盛りあがら 盛り上がら 盛上がら
もりあがり	盛りあがり 盛り上がり 盛り上り 盛上がり
もりあがる	もり上がる 盛りあがる 盛り上がる 盛り上る 盛上がる
もりあげ	もり上げ 盛りあげ 盛り上げ 盛上げ
もりあげる	もり上げる 盛りあげる 盛り上げる 盛上げる
もりかえし	盛りかえし 盛り返し 盛返し
もりかえす	盛りかえす 盛り返す
もりこま	盛りこま 盛り込ま 盛込ま
もりこみ	盛りこみ 盛り込み
もりこむ	盛りこむ 盛り込む 盛込む
もりこもう	盛りこもう 盛り込もう
もりこん	盛りこん 盛り込ん 盛込ん
もりたて	もり立て 守り立て 盛りたて 盛り立て 盛立て
もりたてよう	盛りたてよう 盛り立てよう
もりたてる	もり立てる 守り立てる 盛りたてる 盛り立てる
もりつけ	盛りつけ 盛り付け 盛付け
もりつける	盛りつける 盛り付ける
もりつけれ	盛りつけれ 盛り付けれ
もりつぶし	盛りつぶし 盛り潰し
もる	洩る 漏る 盛る
もれ	洩れ 漏れ
もれきい	洩れ聞い 漏れ聞い
もれきこえ	洩れ聞こえ 漏れ聞こえ
もれで	もれ出 漏れ出
もれる	洩れる 漏れる 盛れる
もれれ	洩れれ 漏れれ
もろう	盛ろう 貰う
やい	妬い 灼い 焼い
やか	妬か 灼か 焼か
やき	妬き 灼き 焼き 燒き
やきあがっ	焼きあがっ 焼き上がっ 焼き上っ
やきあがり	焼きあがり 焼き上がり
やきあがる	焼きあがる 焼き上がる
やきあげ	焼きあげ 焼き上げ 焼き揚げ
やきあげる	焼きあげる 焼き上げる 焼き揚げる
やきかため	焼きかため 焼き固め
やききっ	焼ききっ 焼き切っ
やききる	焼ききる 焼き切る 焼切る
やききれ	焼ききれ 焼き切れ
やきすて	焼きすて 焼き捨て 焼き棄て
やきつい	焼きつい 焼き付い 焼付い
やきつか	焼きつか 焼き付か
やきつき	焼きつき 焼き付き 焼付き
やきつく	灼きつく 焼きつく 焼き付く
やきつけ	灼きつけ 焼きつけ 焼き付け 焼付け
やきつける	焼きつける 焼き付ける
やきはらい	焼き払い 焼払い
やきはらおう	焼きはらおう 焼き払おう
やきはらっ	焼きはらっ 焼き払っ 焼払っ
やきはらわ	焼きはらわ 焼き払わ 焼払わ
やきもどし	焼きもどし 焼き戻し
やく	妬く 灼く 焼く
やくさ	約さ 訳さ
やくし	扼し 約し 訳し 譯し
やくす	約す 訳す
やくする	扼する 約する 訳する
やくすれ	約すれ 訳すれ
やくせ	約せ 訳せ
やくそ	約そ 訳そ
やくだた	役だた 役立た
やくだっ	役だっ 役立っ
やくだつ	役だつ 役立つ
やくだて	役だて 役立て
やくだてよう	役だてよう 役立てよう
やくだてる	役だてる 役立てる
やけ	灼け 焚 焼け
やけおち	焼けおち 焼け落ち
やけくずれ	焼けくずれ 焼け崩れ
やけこげ	焼けこげ 焼け焦げ
やけただれ	焼けただれ 焼け爛れ
やけただれる	焼けただれる 焼け爛れる
やけつい	焼けつい 焼け付い
やけつく	灼けつく 焼けつく 焼け付く
やける	妬ける 灼ける 焼ける
やしなわ	養なわ 養わ
やじっ	ヤジっ 野次っ
やじら	ヤジら 野次ら
やじり	ヤジり 野次り
やじる	弥次る 野次る
やすまっ	休まっ 安まっ
やすまら	休まら 安まら
やすまり	休まり 安まり
やすまる	休まる 安まる
やすみ	休み 寝み
やすむ	休む 寝む 憩む
やすめ	休め 安め
やすめる	休める 安める
やすも	休も 寝も
やすらう	休らう 安らう
やすん	休ん 寝ん 憩ん
やせ	痩せ 瘠せ 瘦せ
やせおとろえ	やせ衰え 痩せ衰え
やせおとろえる	やせ衰える 痩せ衰える
やせほそっ	やせ細っ 痩せほそっ 痩せ細っ
やせほそら	やせ細ら 痩せ細ら
やせほそり	やせ細り 痩せ細り 瘦せ細り
やせほそる	やせ細る 痩せ細る
やせる	ヤセる 痩せる
やっ	やッ ヤっ 殺っ 演っ
やとい	傭い 雇い
やといあげる	雇い上げる 雇上げる
やといいれ	傭い入れ 雇いいれ 雇い入れ
やとっ	傭っ 雇っ
やとわ	傭わ 雇わ
やぶっ	敗っ 破っ
やぶら	敗ら 破ら
やぶり	敗り 破り
やぶりすて	破りすて 破り捨て 破り棄て
やぶりすてる	破り捨てる 破り棄てる
やぶりとら	破りとら 破り取ら
やぶる	敗る 破る
やぶれ	壞れ 敗れ 破れ
やぶれさっ	敗れ去っ 破れ去っ
やぶれさり	敗れ去り 破れ去り
やぶれさる	敗れ去る 破れ去る
やぶれよう	敗れよう 破れよう
やぶれる	敗れる 破れる
やま	已ま 止ま 病ま
やみ	已み 止み 病み
やみつき	病みつき 病み付き
やむ	已む 止む 熄む 病む
やめ	廃め 病め 罷め 辞め 退め
やめさせ	止めさせ 辞めさせ
やめる	病める 罷める 辞める
やめん	罷めん 辞めん
やら	ヤら 姦ら 殺ら 演ら 犯ら 行ら 遣ら
やり	ヤり 殺り 演り 犯り 行り 遣り
やりかえし	やり返し 遣り返し
やりすごし	やり過ごし やり過し 遣り過ごし
やりすごす	やり過ごす 遣り過ごす 遣り過す
やりすごそう	やり過ごそう 遣り過ごそう
やりとげる	やり遂げる 遣り遂げる
やりのこし	やり残し 遣り残し
やる	やル ヤる 殺る 演る 犯る 行る 遣る
やれ	ヤれ 殺れ 演れ 犯れ 行れ
やれる	ヤレる 殺れる 演れる
やろう	殺ろう 演ろう 遣ろう 飲ろう
やわらげ	和げ 和らげ 柔らげ
やわらげる	和らげる 柔げる 柔らげる
やん	已ん 止ん 演ん 熄ん 病ん 行ん
ゆいあげ	結いあげ 結い上げ
ゆいあげる	結いあげる 結い上げる
ゆう	結う 言う
ゆうし	幽し 有し
ゆうせ	幽せ 有せ
ゆがい	湯がい 湯掻い
ゆきあい	行き会い 行き逢い
ゆきあっ	行き会っ 行き逢っ 行合っ
ゆきあわ	行き会わ 行合わ
ゆきかう	往き交う 行きかう
ゆきだおれ	行きだおれ 行き倒れ
ゆきづまっ	ゆき詰まっ 行詰っ
ゆける	往ける 行ける
ゆさぶっ	揺さぶっ 揺さ振っ
ゆさぶり	揺さぶり 揺さ振り
ゆさぶる	揺さぶる 揺さ振る
ゆすら	揺すら 揺ら
ゆすり	揺すり 揺り
ゆすりおこし	ゆすり起こし 揺すり起こし
ゆすりとっ	ゆすり取っ 強請り取っ
ゆすりとら	ゆすり取ら 強請り取ら
ゆすりとる	ゆすり取る 強請りとる 強請り取る
ゆすりとろう	ゆすり取ろう 強請り取ろう
ゆする	揺する 揺る 輸する
ゆずっ	譲っ 讓っ
ゆずら	譲ら 讓ら
ゆずり	譲り 讓り
ゆずりあい	ゆずり合い 譲り合い
ゆずりあう	ゆずり合う 譲り合う
ゆずりあっ	ゆずり合っ 譲り合っ
ゆずりうけ	ゆずり受け 譲りうけ 譲り受け
ゆずりうける	ゆずり受ける 譲りうける 譲り受ける
ゆずりわたさ	譲り渡さ 讓渡さ
ゆずりわたし	ゆずり渡し 譲りわたし 譲り渡し
ゆずりわたす	ゆずり渡す 譲り渡す
ゆずる	譲る 讓る
ゆずれ	譲れ 讓れ
ゆっ	結っ 言っ
ゆであがっ	ゆで上がっ 茹であがっ 茹で上がっ
ゆであがり	ゆで上がり 茹で上がり
ゆであがる	茹であがる 茹で上がる
ゆであげ	ゆで上げ 茹であげ 茹で上げ
ゆであげる	ゆで上げる 茹であげる 茹で上げる
ゆでこぼす	茹でこぼす 茹で溢す
ゆびささ	指ささ 指差さ
ゆびさし	指さし 指差し
ゆびさす	指さす 指差す
ゆびさせ	指させ 指差せ
ゆめみ	夢み 夢見
ゆめみる	夢みる 夢見る
ゆりうごかし	ゆり動かし 揺り動かし
ゆりうごかす	ゆり動かす 揺り動かす
ゆりおこさ	ゆり起こさ 揺り起こさ
ゆりおこし	ゆり起こし 揺り起こし
ゆるが	揺が 揺るが
ゆるがし	揺がし 揺るがし
ゆるがす	揺がす 揺るがす
ゆるぎ	揺ぎ 揺るぎ
ゆるぐ	揺ぐ 揺るぐ
ゆるさ	免さ 許さ 赦さ
ゆるし	免し 宥し 許し 赦し
ゆるしあう	許しあう 許し合う
ゆるしあっ	許しあっ 許し合っ
ゆるす	許す 赦す
ゆるせ	宥せ 肯せ 許せ 赦せ
ゆるそう	許そう 赦そう
ゆるま	弛ま 緩ま
ゆるみ	弛み 緩み
ゆるむ	弛む 緩む
ゆるめ	弛め 緩め 緩るめ
ゆるめる	弛める 緩める
ゆるん	弛ん 緩ん
ゆれうごい	ゆれ動い 揺れ動い
ゆれうごか	揺れうごか 揺れ動か
ゆれうごき	ゆれ動き 揺れ動き
ゆれうごく	ゆれ動く 揺れ動く
ゆわ	結わ 言わ
ゆわい	結い 結わい
ゆわえ	結え 結わえ
ゆわえつけ	ゆわえ付け 結え付け 結わえつけ 結わえ付け
ゆわえる	結える 結わえる
よい	酔い 醉い
よいしれ	酔いしれ 酔い痴れ
よいしれる	酔いしれる 酔い痴れる
よいつぶさ	酔いつぶさ 酔い潰さ
よいつぶし	酔いつぶし 酔い潰し
よいつぶす	酔いつぶす 酔い潰す
よいつぶれ	酔いつぶれ 酔い潰れ
よいつぶれる	酔いつぶれる 酔い潰れる
ようさ	擁さ 要さ
ようし	擁し 用し 要し
ようしよう	擁しよう 要しよう
ようす	擁す 要す
ようする	擁する 用する 要する
ようせ	擁せ 要せ
ようせよ	用せよ 要せよ
よぎっ	過ぎっ 過っ
よぎり	過ぎり 過り
よくばる	欲ばる 欲張る
よこぎっ	横ぎっ 横切っ
よこぎり	横ぎり 横切り
よこぎる	横ぎる 横切る
よこさ	寄こさ 寄越さ
よこし	寄こし 寄越し
よこす	寄こす 寄越す
よこせ	寄こせ 寄越せ
よこそう	寄こそう 寄越そう
よこたはり	横たはり 横はり
よこたわる	横たわる 横わる
よこづけ	横づけ 横付け
よこばい	横ばい 横這い
よじのぼっ	よじ上っ よじ登っ 攀じ登っ
よじのぼら	よじ登ら 攀じ登ら
よじのぼり	よじ上り よじ登り 攀じ登り
よじのぼる	よじ上る よじ登る 攀じ登る
よせ	寄せ 止せ 襲せ
よせあい	寄せあい 寄せ合い
よせあう	寄せあう 寄せ合う
よせあっ	寄せあっ 寄せ合っ
よせあつめ	よせ集め 寄せ集め
よせあわ	寄せあわ 寄せ合わ
よせつけ	寄せつけ 寄せ付け
よせつける	寄せつける 寄せ付ける
よせる	寄せる 襲せる
よそおい	粧い 装い
よそおう	粧う 装う
よそおわ	粧わ 装わ
よっ	依っ 依ッ 因っ 因ッ 寄っ 拠っ 撚っ 據っ 由っ 縁っ 縒っ 酔っ
よっぱらい	酔っぱらい 酔っ払い 酔払い
よっぱらう	酔っぱらう 酔っ払う 酔払う
よっぱらっ	酔っぱらっ 酔っ払っ 酔払っ
よっぱらわ	酔っぱらわ 酔っ払わ
よどま	淀ま 澱ま
よどみ	淀み 澱み
よどむ	淀む 澱む
よどん	淀ん 澱ん
よば	呼ば 喚ば 招ば 称ば
よび	呼び 喚び 称び
よびあつめ	よび集め 呼び集め
よびいれ	呼びいれ 呼び入れ
よびおこさ	呼びおこさ 呼び起こさ 呼び起さ 呼起さ 喚び起こさ
よびおこし	呼びおこし 呼び起こし 呼び起し 喚び起こし
よびおこす	よび起こす 呼びおこす 呼び起こす 喚び起こす
よびおろし	呼び下ろし 呼び降ろし
よびかえ	呼びかえ 呼び変え 呼び換え 呼び替え
よびかえす	呼びかえす 呼び返す
よびかえる	呼びかえる 呼び変える 呼び換える 呼び替える
よびかけ	呼びかけ 呼び掛け
よびかける	呼びかける 呼び掛ける
よびこま	呼びこま 呼び込ま
よびこみ	呼びこみ 呼び込み 呼込み
よびこむ	呼びこむ 呼び込む
よびこもう	呼びこもう 呼び込もう
よびこん	呼びこん 呼び込ん
よびさまさ	呼びさまさ 呼び覚まさ
よびさまし	呼びさまし 呼び覚まし 呼び醒まし
よびさます	よび覚ます 呼びさます 呼び覚ます 呼び醒ます
よびさませ	呼び覚ませ 呼び醒ませ
よびさまそう	呼びさまそう 呼び覚まそう 呼び醒まそう 喚び醒まそう
よびたて	呼びたて 呼び立て
よびたてる	呼びたてる 呼び立てる
よびださ	呼びださ 呼び出さ 呼出さ
よびだし	呼びだし 呼び出し 呼出し
よびだす	よび出す 呼びだす 呼び出す 呼出す
よびだせ	呼びだせ 呼び出せ
よびだそう	呼びだそう 呼び出そう
よびつけ	呼びつけ 呼び付け
よびつける	呼びつける 呼び付ける
よびとめ	呼びとめ 呼び止め
よびとめる	呼びとめる 呼び止める
よびならし	呼びならし 呼び慣らし
よびならわさ	呼びならわさ 呼び習わさ
よびならわし	呼びならわし 呼び習わし
よびならわす	呼びならわす 呼び習わす
よびもとめ	よび求め 呼び求め
よびもどさ	呼びもどさ 呼び戻さ 呼戻さ
よびもどし	よび戻し 呼びもどし 呼び戻し
よびもどす	呼びもどす 呼び戻す
よびもどそう	呼びもどそう 呼び戻そう
よびよせ	呼びよせ 呼び寄せ 呼寄
よびよせる	よび寄せる 呼びよせる 呼び寄せる
よぶ	呼ぶ 喚ぶ
よま	訓ま 詠ま 誦ま 読ま 讀ま
よまう	詠まう 読まう
よみ	訓み 詠み 誦み 読み 讀み
よみあげ	よみ上げ 詠みあげ 読みあげ 読み上げ 読上げ
よみあげる	よみ上げる 詠みあげる 読みあげる 読み上げる 読上げる
よみあさっ	読みあさっ 読み漁っ
よみあさり	読みあさり 読み漁り
よみあさる	読みあさる 読み漁る
よみあわせ	詠み合わせ 読み合わせ
よみかえ	読みかえ 読み変え 読み換え 読み替え 読替え
よみかえし	読みかえし 読み返し
よみかえる	読みかえる 読み換える 読み替える
よみかえれ	読み換えれ 読み替えれ
よみがえっ	甦っ 蘇えっ 蘇っ
よみがえら	甦ら 蘇えら 蘇ら
よみがえらさ	甦らさ 蘇らさ
よみがえらす	甦らす 蘇らす
よみがえらせ	甦らせ 蘇らせ
よみがえり	甦えり 甦り 蘇えり 蘇り 蘇生り
よみがえる	甦える 甦る 蘇える 蘇る
よみがえれ	甦れ 蘇れ
よみがえろう	甦ろう 蘇ろう
よみきかせ	読み聞かせ 読み聴かせ
よみくだし	訓み下し 読み下し
よみくだす	読みくだす 読み下す
よみくらべ	読み比べ 読み較べ
よみこま	詠みこま 詠み込ま 読みこま 読み込ま 読込ま
よみこみ	詠み込み 読みこみ 読み込み 読込み
よみこむ	詠みこむ 詠み込む 読みこむ 読み込む
よみこめ	読みこめ 読み込め
よみこん	詠みこん 詠み込ん 読みこん 読み込ん
よみすすむ	読みすすむ 読み進む
よみすすめ	読みすすめ 読み進め
よみすすめる	読みすすめる 読み進める
よみちがえ	読みちがえ 読み違え
よみつい	読みつい 読み継い
よみつが	読みつが 読み継が
よみとき	読みとき 読み解き
よみとく	読みとく 読み解く
よみとっ	読みとっ 読み取っ 読取っ
よみとら	読みとら 読み取ら
よみとり	読みとり 読み取り 読取り
よみとる	読みとる 読み取る 読取る
よみとれ	読みとれ 読み取れ 読取れ
よみとれる	読みとれる 読み取れる
よみとろう	読みとろう 読み取ろう
よみなおさ	読みなおさ 読み直さ
よみなおし	読みなおし 読み直し
よみなおす	読みなおす 読み直す
よみなおせ	読みなおせ 読み直せ
よみふけっ	読みふけっ 読み耽けっ 読み耽っ
よみふけり	読みふけり 読み耽り
よみふける	読みふける 読み耽ける 読み耽る
よむ	訓む 詠む 読む
よめ	詠め 誦め 読め 讀め
よめる	訓める 詠める 読める
よめれ	詠めれ 読めれ
よもう	詠もう 読もう
よら	依ら 倚ら 因ら 寄ら 拠ら 撚ら 據ら 由ら 縒ら 老 老ら
より	依り 倚り 因り 寄り 拠り 撚り 撰り 據り 由り 縁り 縒り 老
よりあい	寄り合い 寄合い
よりあっ	寄り合っ 寄合っ
よりあつまっ	寄りあつまっ 寄り集まっ 縒り集まっ
よりあわせ	より合わせ 撚りあわせ 撚り合せ 撚り合わせ 縒りあわせ 縒り合わせ
よりあわせる	より合わせる 撚り合せる 撚り合わせる 縒り合わせる
よりかかっ	寄りかかっ 寄り掛かっ 寄り掛っ
よりかから	寄りかから 寄り掛から
よりかかり	寄りかかり 寄り掛かり
よりかかる	寄りかかる 寄り掛かる
よりかかれる	寄りかかれる 寄り掛かれる
よりきり	寄り切り 寄切り
よりそい	寄りそい 寄り添い
よりそう	より添う 寄りそう 寄り沿う 寄り添う 寄添う
よりそっ	寄りそっ 寄り沿っ 寄り添っ
よりたて	寄りたて 寄り立て
よりたのみ	依り頼み 寄り頼み
よりつい	依り憑い 寄りつい 寄り付い 憑りつい
よりつか	依り憑か 寄りつか 寄り付か 憑りつか
よりつき	依り憑き 寄りつき 寄り付き 寄付き 憑りつき
よりつく	依り憑く 寄りつく 寄り付く 憑りつく
よりつけ	依り憑け 寄りつけ 寄り付け
よりわけ	より分け 選り分け
よりわける	より分ける 選り分ける
よる	依る 依ル 倚る 因る 因ル 寄る 拠る 撚る 據る 由る 縁る 縒る 老
よれ	依れ 因れ 寄れ 拠れ 由れ 縒れ
よれる	ヨレる 寄れる 縒れる
よろう	依ろう 寄ろう 拠ろう 鎧う
よろこば	喜ば 悦ば 慶ば 歓ば
よろこび	喜び 嬉び 悦び 慶び 欣び 歓び
よろこびいさん	よろこび勇ん 喜び勇ん 悦び勇ん
よろこぶ	喜ぶ 悦ぶ 慶ぶ 歓ぶ
よろこべ	喜べ 悦べ
よろこべる	喜べる 悦べる
よろこん	喜ん 悦ん 慶ん 歓ん
よわす	酔はす 酔わす
よわせ	酔はせ 酔わせ
よん	呼ん 喚ん 拠ん 撰ん 称ん 訓ん 詠ん 誦ん 読ん
りし	利し 理し
りする	利する 理する
りせ	利せ 理せ
りょうし	了し 猟し 領し
りょうする	了する 猟する 領する
りょうすれ	了すれ 領すれ
りょうせ	諒せ 領せ
るいし	累し 類し
れいし	令し 隷し
れいする	令する 隷する
ろうし	労し 弄し
ろうする	労する 弄する 聾する
わい	沸い 涌い 湧い
わか	沸か 涌か 湧か
わかがえっ	若がえっ 若返っ
わかさ	沸かさ 湧かさ
わかし	沸かし 涌かし 湧かし
わかす	沸かす 湧かす
わかせ	沸かせ 湧かせ
わかそう	沸かそう 湧かそう
わかた	分かた 分た 別た
わかち	分かち 分ち 別ち
わかちあい	分かちあい 分かち合い 分ち合い
わかちあう	わかち合う 分かちあう 分かち合う 分ち合う
わかちあえる	分かちあえる 分かち合える
わかちあおう	分かちあおう 分かち合おう
わかちあたえ	わかち与え 分かち与え
わかちあたえる	分かち与える 分ち与える
わかちあっ	分かちあっ 分かち合っ 分ち合っ
わかちもつ	分かち持つ 分ち持つ
わかっ	分かっ 分っ 判かっ 判っ 別っ 解かっ 解っ
わかつ	分かつ 分つ 別つ
わから	分から 分ら 判から 判ら 解から 解ら 訣ら
わかり	分かり 分り 判かり 判り 解かり 解り
わかりあい	わかり合い 分かり合い
わかりあう	わかり合う 分かり合う
わかりあえ	わかり合え 分かりあえ 分かり合え 解り合え
わかりあえる	わかり合える 分かりあえる 分かり合える 解り合える
わかりあっ	分かりあっ 分かり合っ
わかる	分かる 分る 判る 解かる 解る
わかれ	分かれ 分れ 判れ 別 別かれ 別れ 岐れ 解かれ 解れ 訣れ
わかれよ	別よ 別れよ
わかれよう	分かれよう 別れよう
わかれる	分かれる 分れる 別かれる 別る 別れる 岐れる
わかれれ	分かれれ 別れれ
わかれろ	分かれろ 別れろ
わかろう	分かろう 解ろう
わかん	分かん 分ん 解ん
わき	沸き 涌き 湧き
わきあがっ	わき上がっ 沸きあがっ 沸き上がっ 沸上がっ 湧きあがっ 湧き上がっ
わきあがら	わき上がら 沸きあがら 沸き上がら 湧きあがら 湧き上がら
わきあがり	わき上がり 沸きあがり 沸き上がり 湧きあがり 湧き上がり
わきあがる	わき上がる 沸きあがる 沸き上がる 沸き上る 湧きあがる 湧き上がる
わきあがれ	湧きあがれ 湧き上がれ
わきおこさ	わき起こさ 沸き起こさ
わきおこし	沸き起こし 湧き起こし
わきおこす	沸き起こす 湧き起こす
わきおこっ	わき起こっ 沸きおこっ 沸き起こっ 湧きおこっ 湧き起こっ 湧き起っ
わきおこら	沸き起こら 湧き起こら
わきおこり	わき起こり 沸きおこり 沸き起こり 湧き起こり
わきおこる	わき起こる 沸き起こる 湧きおこる 湧き起こる 湧き起る
わきかえっ	わき返っ 沸きかえっ 沸き返っ 湧きかえっ 湧き返っ
わきかえり	沸きかえり 沸き返り 湧きかえり
わきかえる	沸き返る 湧き返る
わきたた	沸き立た 湧き立た
わきたち	沸き立ち 湧きたち 湧き立ち
わきたっ	わき立っ 沸きたっ 沸き立っ 湧きたっ 湧き立っ
わきたつ	沸きたつ 沸き立つ 涌き立つ 湧き立つ
わきださ	わき出さ 湧き出さ 湧出さ
わきだし	わき出し 沸き出し 湧き出し 湧出し
わきだす	わき出す 沸き出す 湧き出す 湧出す
わきで	わき出 沸き出 涌き出 湧きで 湧き出 湧出
わきでる	わき出る 沸き出る 涌き出る 湧きでる 湧き出る 湧出る
わく	沸く 涌く 湧く
わけ	分 分け 別け 沸け 湧け 頒け
わけあい	分けあい 分け合い
わけあう	分けあう 分け合う
わけあたえる	分けあたえる 分け与える
わけあっ	分けあっ 分け合っ
わけいっ	わけ入っ 分け入っ 分入っ
わけいら	分け入ら 分入ら
わけいり	分け入り 分入り
わけいる	わけ入る 分け入る 分入る
わけいれ	分け入れ 分入れ
わけへだて	分けへだて 分け隔て
わけへだてる	分けへだてる 分け隔てる
わける	分ける 別ける
わすれ	和すれ 忘 忘れ
わすれさら	忘れさら 忘れ去ら
わすれる	忘る 忘れる
わずらい	患い 煩い
わずらう	患う 煩う
わずらっ	患っ 煩っ
わずらわ	患わ 煩わ
わずらわさ	労さ 煩わさ
わずらわし	労し 煩はし 煩わし
わずらわす	労す 煩わす
わたっ	ワタっ 亘っ 亙っ 渉っ 渡っ 渡ッ
わたら	亘ら 亙ら 渉ら 渡ら 航ら
わたり	ワタり 亘り 亙り 渉り 渡り 航り
わたりあい	わたり合い 渡りあい 渡り合い
わたりあう	わたり合う 渡りあう 渡り合う
わたりあえ	渡りあえ 渡り合え
わたりあえる	わたり合える 渡り合える
わたりあっ	わたり合っ 渡りあっ 渡り合っ
わたりあるい	わたり歩い 渡りあるい 渡り歩い
わたりあるき	わたり歩き 渡りあるき 渡り歩き
わたりあるく	わたり歩く 渡り歩く
わたる	ワタる 亘る 亙る 渉る 渡る 航る
わたれ	ワタれ 亘れ 渉れ 渡れ
わたろう	渉ろう 渡ろう
わななか	戦慄か 揺か
わび	侘 侘び 詫 詫び
わびる	侘びる 詑びる 詫びる
わめきたて	喚きたて 喚き立て
わめきたてる	わめき立てる 喚きたてる 喚き立てる
わめきちらし	わめき散らし 喚き散らし
わめきちらす	わめき散らす 喚き散らす
わらい	嗤い 微笑い 笑い
わらいあい	笑いあい 笑い合い
わらいあう	笑いあう 笑い合う
わらいあえる	笑いあえる 笑い合える
わらいあっ	笑いあっ 笑い合っ
わらいころげ	笑いころげ 笑い転げ
わらいころげる	笑いころげる 笑い転げる
わらいとばし	笑いとばし 笑い飛ばし
わらいとばす	笑いとばす 笑い飛ばす
わらいとばせ	笑いとばせ 笑い飛ばせ
わらう	嗤う 微笑う 笑う
わらっ	嗤っ 微笑っ 笑っ
わらは	哂は 笑は
わらふ	嗤ふ 笑ふ
わらわ	嗤わ 微笑わ 笑わ
わりあて	割りあて 割り当て 割当 割当て
わりあてる	割りあてる 割り当てる 割当てる 割当る
わりいれ	割りいれ 割り入れ
わりきっ	割りきっ 割り切っ
わりきら	割りきら 割り切ら
わりきる	割りきる 割り切る
わりきれ	割りきれ 割り切れ 割切れ
わりきれる	割りきれる 割り切れる
わりこま	割りこま 割り込ま
わりこみ	割りこみ 割り込み 割込み
わりこむ	ワリコむ 割りこむ 割り込む 割込む
わりこん	割りこん 割り込ん 割込ん
わりださ	割り出さ 割出さ
わりだし	割りだし 割り出し 割出し
わりだす	割りだす 割り出す 割出す
わりびい	割り引い 割引い
わりびか	割り引か 割引か
わりびき	割り引き 割引き
わりびく	割り引く 割引く
わりふっ	割りふっ 割り振っ
わりふら	割りふら 割り振ら 割振ら
わりふり	割りふり 割り振り 割振り
わりふる	割りふる 割り振る 割振る
わる	÷ 割る ／
われ	割 割れ
わろう	割ろう 笑 笑う
